134 sites
11100000000000000000000000000000000000000000000000000000000000000001111000000000000100000000000000000000000000001000000000000000000000
11110000000000000000000000000000000000000000000000000000000000000001100000000000000000000000000000000000000000000000000000000000000000
11111000000000000000000000000000000000000000000000000000000000000111000000000000000001000000000000000000000000000000000000000000000000
01111100000000000001100000000000000000000000000000000000000000000111100000000000000000000000000000000000000000000000000000000000000000
00111110000000000000000000000000000000000000000000000000000000011100000000000000000000000000000000000000000000000000000000000000000000
00011111000000000111000000000000000000000000000000000000000000001110000000000000000010000000000000000000000000000000000000000000000000
00001111100000000110000000000000000000000000000000000000000000001000000000000000000000000000000000000000000000000000000000000000000000
00000111111000001110000000000000000000000000000000000000001101001000000000000000000000000000000000000000000000000000000000000000000000
00000011110000001110000100000000000000000000000000000000000000000000000000000000000000000000000000000000000000000000000000000000000000
00000001111100001000000000000000000000000000000000000000000000000000000000000000000000000000000000000000000000000000000000000000000000
00000001011110001000000000000000000000000000000000010011001100000000000000000000000000000000000000000000000000000000000000000000000000
00000000011110011000000001000000000000000000000000000000000000000000000000000000000000000000000000000000000000000000000000000000000000
00000000001111110000000000000000010011000000000100110010000000000000000000000000000000000000000000000000000000000000000000000000000000
00000000000011110000000000000000011010000000000101110110000000000000000000000000000000000000000100001100000000000000000000000000000000
00000000000011110000000000011001110000000000000000100010000000000000000000000000000000000000100100000100000000000000000000000000000000
00000000000111110000000001111000000000000000000000000000000000000000000000000001000000000000000000000000000000000000000000000000000000
00000001111100001100000111100000000000000000000000000000000000000000000000000000000000000000000000000000000000000000000000000000000000
00000111100000001111000111100000000000000000000000000000000000001010000000000000100010000000000000000000000000000000000000000000000000
00000111100000000111011100000000000000000000000000000000000000000000000000000000000000000000000000000000000000000000000000000000000000
00010100000000000111111110100000000000000000000000000000000000000010000000000000100000000000000000000000000000000000000000000000000000
00010000000000000001111000000000000000000000000000000000000000000000000000000000000000000000000000000000000000000000000000000000000000
00000000000000000011111000000000000000000000000000000000000000000000000000000000000000000000000000000000000000000000000000000000000000
00000000000000000011111110000000000000000000000000000000000000000000000000000000000000000000000000000000000000000000000000000000000000
00000000100000001111001110000000000000000000000000000000000000000000000000000000000000000000000000000000000000000000000000000000000000
00000000000000001101001111100000000000000000000000000000000000000000000000000011100000000000000000000000000000000000000000000000000000
00000000000100011100000011110000000000000000000000000000000000000000000000000011100000000000000000000000000000000000000000000000000000
00000000000000011101000011111000000000000000000000000000000000000010000000000001111010000000000000000000000000000000000000000000000000
00000000000000110000000001111100000000000000000000000000000000000000000000010001111000000000000000000000000000000000000000000000000000
00000000000000110000000000111111000000000000000000000000000000000000000000000000001110000001100100000100000000000000000000000000000000
00000000000000000000000000011111000000000000000000000000000000000000010000000000011100000000100000000000000000100100000000000000000000
00000000000000000000000000001111000000000000000000000000000000000000000000000000000000000000100000000001111000110110010000000000000000
00000000000000100000000000001111110000000000000000000000000000000000000000000000000000000000100110000111110000000000010000000000000000
00000000000000100000000000000001111000000000000000000000000000000000000000000000000000000000000000000111110000000000000000000000000000
00000000000011100000000000000001111000000000001100110010000000000000000000000000000000000000000100001100000000000000000000000000000000
00000000000001000000000000000000111110000001111100100000000000000000000000000000000000000000000000000000000000000000000000000000000100
00000000000000000000000000000000001111100111100100000000000000000000000000000000000000000000000000000000000000000000000000000000000000
00000000000011000000000000000000001111000001100110010000000000000000000000000000000000000000000000000000000000000000000000000000000000
00000000000010000000000000000000000111100000000000000000000000000000000000000000000000000000000000000000000000000000000000000000000000
00000000000000000000000000000000000101111110000000000000000000000000000000000000000000000000000000000000000000000000000000000000000000
00000000000000000000000000000000000000111110000000000000000000000000000000000000000000000000000000000000000000000000000000000000000000
00000000000000000000000000000000000000111110000000000000000000000000000000000000000000000000000000000000000000000000000000000000000000
00000000000000000000000000000000000100111111100000000000000000000000000000000000000000000000000000000000000000000000000000000000000000
00000000000000000000000000000000000100111111100000000000000000000000000000000000000000000000000000000000000000000000000000000000000000
00000000000000000000000000000000001110000111100110000000000000000000000000000000000000000000000000000000000000000000000000000000000000
00000000000000000000000000000000001110000111111100000000000000000000000000000000000000000000000000000000000000000000000000000000000000
00000000000000000000000000000000001000000000111100000000000000000000000000000000000000000000000000000000000000000000000000000000000100
00000000000000000000000000000000011000000000111111100000000000000000000000000000000000000000000000011000000000000000000000000000001100
00000000000011000000000000000000011110000001111111110000000000000000000000000000000000000000000000000000000000000000000000000000000000
00000000000000000000000000000000000010000001001111111000000000000000000000000000000000000000000000000000000000000000000000000000000000
00000000000001000000000000000000000000000000001111111100000000000000000000000000000000000000000000001000000000000000000000000000001000
00000000000011100000000000000000011000000000001111111110000000000000000000000000000000000000000100001100000000000000000000000000000000
00000000001011000000000000000000010010000000000111111111000000000000000000000000000000000000000000000000000000000000000000000000000000
00000000000000000000000000000000000000000000000011111111100000000000000000000000000000000000000000000000000000000000000000000000000000
00000000000001000000000000000000000000000000000001111111110000000000000000000000000000000000001100101000000000000000000000000000000000
00000000001011100000000000000000010000000000000000111111111000000000000000000000000000000001000100000000000000000000000000000000000000
00000000001000000000000000000000000000000000000000011111111100000000000000000000000000000000000000000000000000000000000000000000000000
00000000000000000000000000000000000000000000000000001111111110000000000000000000000000000000000000000000000000000000000000000000000000
00000000000000000000000000000000000000000000000000000111111111000000000000000000000000100101001000000000000000000000000000000000000000
00000001001000000000000000000000000000000000000000000011111111001000000000000000000010100001000000000000000000000000000000000000000000
00000001001000000000000000000000000000000000000000000001111111000000000000000000000000000000000000000000000000000000000000000000000000
00000000000000000000000000000000000000000000000000000000111111000000000000000000000000100000000000000000000000000000000000000000000000
00000001000000000000000000000000000000000000000000000000011111111000000000000000000000110000000000000000000000000000000000000000000000
00000000000000000000000000000000000000000000000000000000000001110000000000000000000000010000000000000000000000000000000000000000000000
00001000000000000000000000000000000000000000000000000000000001111100000000000000000000110000000000000000000000000000000000000000000000
00001111000000000100000000000000000000000000000000000000001001011110000000000000000011100000000000000000000000000000000000000000000000
00111100000000000000000000000000000000000000000000000000000000011111000000000000000011000000000000000000000000000000000000000000000000
00110100000000000101000000100000000000000000000000000000000000001111100000000000101111000000000000000000000000000000000000000000000000
11110000000000000000000000000000000000000000000000000000000000000111110000000000001111000000000000000000000000000000000000000000000000
11010000000000000000000000000000000000000000000000000000000000000011110001000000111100000000000000000000000000000000000000000000000000
10000000000000000000000000000100000000000000000000000000000000000001111101000000011100000000000000000000000001111100000000000000000000
10000000000000000000000000000000000000000000000000000000000000000000011100000000000000000000000000000000000001101000000000000000000000
00000000000000000000000000000000000000000000000000000000000000000000011111000000000000000000000000000000000111100000000000000000000000
00000000000000000000000000000000000000000000000000000000000000000000000111110000010000000000000000000000000000100000000000000000000000
00000000000000000000000000000000000000000000000000000000000000000000110111100000111000000000000000000000000000000000000000000000000000
00000000000000000000000000000000000000000000000000000000000000000000000011110011110000000000000000000000000000000000000000000000000000
00000000000000000000000000010000000000000000000000000000000000000000000010111111010000000000000000000000000000000000000000000000000000
00000000000000000000000000000000000000000000000000000000000000000000000000011110000000000000000000000000000000000000000000000000000000
00000000000000000000000000000000000000000000000000000000000000000000000000011111000000000000000000000000000000000000000000000000000000
00000000000000000000000011000000000000000000000000000000000000000000000000111111000000000000000000000000000000000000000000000000000000
00000000000000010000000011110000000000000000000000000000000000000000000000110111110000000000000000000000000000000000000000000000000000
00000000000000000101000011110000000000000000000000000000000000000010100001100001111000000000000000000000000000000000000000000000000000
00000000000000000000000000110100000000000000000000000000000000000000110011110001111000000000000000000000000000100000000000000000000000
00000000000000000000000000111100000000000000000000000000000000000011110001000000111110000000000000000000000000000000000000000000000000
10000000000000000000000000001100000000000000000000000000000000000011110000000000001111000011100000000000000000000100000000000000000000
00000100000000000100000000101000000000000000000000000000001000001111000000000000001111100011100000000000000000000000000000000000000000
00100000000000000000000000000000000000000000000000000000000000001111000000000000000111111111000000000000000000000000000000000000000000
00000000000000000000000000000000000000000000000000000000011011011000000000000000000011111101001000000000000000000000000000000000000000
00000000000000000000000000000000000000000000000000000000000001110000000000000000000001111100000000000000000000000000000000000000000000
00000000000000000000000000000000000000000000000000000000000000000000000000000000000001111100000000000000000000000000000000000000000000
00000000000000000000000000000000000000000000000000000000010000000000000000000000000001111111011000000000000000000000000000000000000000
00000000000000000000000000000000000000000000000000000000000000000000000000000000000111000111111000000000000000000100000000000000000000
00000000000000000000000000001000000000000000000000000010011000000000000000000000000111100111111100000000000000000000000000000000000000
00000000000000100000000000001111000000000000000000000000000000000000000000000000000110000011111110000100000000000100010000000000000000
00000000000000000000000000000000000000000000000000000000000000000000000000000000000000000111111111000000000000000100110010000000000000
00000000000000000000000000000000000000000000000000000100010000000000000000000000000000100111111111100000000000000000000000000000000000
00000000000001100000000000001001010000000000000000100110000000000000000000000000000000000001111111101100000000000000000000000000000000
00000000000000000000000000000001000000000000000000000000000000000000000000000000000000000000111111111111000000000000010011001000000000
00000000000000000000000000000000000000000000000000000000000000000000000000000000000000000000011111110000000000000000000011011000000000
00000000000000000000000000000000000000000000000000000100000000000000000000000000000000000000001111111100000000000000000000001000011000
00000000000000000000000000000000000000000000001000000000000000000000000000000000000000000000000011111100000000000000000000001101111111
00000000000001000000000000000000010000000000001001100100000000000000000000000000000000000000000110111100000000000000000000000000001100
00000000000001100000000000001001110000000000000000100000000000000000000000000000000000000000100110111111000000000000000000000000000100
00000000000000000000000000000001100000000000000000000000000000000000000000000000000000000000000010000111100000000000000001000000000100
00000000000000000000000000000011100000000000000000000000000000000000000000000000000000000000000010000111101000000010011001000000000000
00000000000000000000000000000011100000000000000000000000000000000000000000000000000000000000000000000011111000000000000000000000000000
00000000000000000000000000000011100000000000000000000000000000000000000000000000000000000000000000000000111100000000000000000000000000
00000000000000000000000000000010000000000000000000000000000000000000000000000000000000000000000000000001111110110010000000000000000000
00000000000000000000000000000000000000000000000000000000000000000000000100000000000000000000000000000000011110110000000000000000000000
00000000000000000000000000000000000000000000000000000000000000000000000100000000000000000000000000000000001111110000000000000000000000
00000000000000000000000000000000000000000000000000000000000000000000011100000000000000000000000000000000000011110000000000000000000000
00000000000000000000000000000110000000000000000000000000000000000000011110000000010000000000000000000000001111111000000000000000000000
00000000000000000000000000000010000000000000000000000000000000000000010000000000000000000000000000000000001111111110000000000000000000
10000000000000000000000000000000000000000000000000000000000000000000011000000000000000000000000000000000000000111110000000000000000000
00000000000000000000000000000110000000000000000000000000000000000000010000000000000100000010110000000000000000011111110000000000000000
00000000000000000000000000000010000000000000000000000000000000000000000000000000000000000000000000000001001000011111111000000000000000
00000000000000000000000000000000000000000000000000000000000000000000000000000000000000000000000000000000000000000111111100000000000000
00000000000000000000000000000000000000000000000000000000000000000000000000000000000000000000010000000000000000000111111110000000000000
00000000000000000000000000000011000000000000000000000000000000000000000000000000000000000000110010000001000000000111111111000000000000
00000000000000000000000000000000000000000000000000000000000000000000000000000000000000000000000000000001000000000011111111100000000000
00000000000000000000000000000000000000000000000000000000000000000000000000000000000000000000000000000000000000000001111111110000000000
00000000000000000000000000000000000000000000000000000000000000000000000000000000000000000000010011000000000000000000111111111000000000
00000000000000000000000000000000000000000000000000000000000000000000000000000000000000000000000011000011000000000000011111111100000000
00000000000000000000000000000000000000000000000000000000000000000000000000000000000000000000000000000000000000000000001111111110000000
00000000000000000000000000000000000000000000000000000000000000000000000000000000000000000000000001000000000000000000000111111111000000
00000000000000000000000000000000000000000000000000000000000000000000000000000000000000000000000011110000000000000000000011111111011110
00000000000000000000000000000000000000000000000000000000000000000000000000000000000000000000000000010000000000000000000001111111110010
00000000000000000000000000000000000000000000000000000000000000000000000000000000000000000000000000000000000000000000000000111111100000
00000000000000000000000000000000000000000000000000000000000000000000000000000000000000000000000000010000000000000000000000011111110010
00000000000000000000000000000000000000000000000000000000000000000000000000000000000000000000000000010000000000000000000000000111110011
00000000000000000000000000000000000000000000000000000000000000000000000000000000000000000000000000110000000000000000000000001101111111
00000000000000000000000000000000000000000000001001000000000000000000000000000000000000000000000000111000000000000000000000001000011111
00000000000000000000000000000000001000000000011000000000000000000000000000000000000000000000000000011110000000000000000000001000011111
00000000000000000000000000000000000000000000000000000000000000000000000000000000000000000000000000010000000000000000000000001101111111
00000000000000000000000000000000000000000000000000000000000000000000000000000000000000000000000000010000000000000000000000000000111111