145 sites
1100000000000000000000000000000000000000000000000000000000000000000000000100000000000000000000000000000000100110010000000000000000000000000000000
1111000000000000000000000000000000000000000000000000000000000000000000000111000000000000000000000000000000000010010000000000000000000000000000000
0111100100000000000000000000000000000000000000000000000000000000000000000010000000000000000000000000000000000000000000000000000000000000000000000
0111100110000000000000000000000000000000000000000000000000000000000000000001010000000000000000000000000000000000000000000000000000000000110010000
0011111110000000000000000000000000000000000000000000000000000000000000000000000000000000000000000000000000000000000000000000000000000100010000000
0000111110000000000000000000000000000000000000000000000000000000000000000000000000000000000000000000000000000000000000000000000000000100000000000
0000111110000000000000000000000100000000000000000000000000000000000000000000000000000000000000000000000000000000000000000000000000000000000000000
0011111111000000000000000001000100000000000000000000000000000000000000000011110000000000000000000000000000000000000000000000000000000000000000000
0001111111100000000000000000000000000000000000000000000000000000000000000000110100000000000000000000000000000000000000000000000000000100110000000
0000000111111000000000010001000000000000000000000000000000000000000000000000111100000000000000000000000000000000000000000000000000000000000000000
0000000011111000000000000000000000000000000000000000000000000000000000000000000100000000000000000000000000000000000000000000000000111100100000000
0000000001111100000000000000000000000000000000000000000000000000000000000000000101000000000000000000000000000000000000000000000000010000000000000
0000000001111110000010010000000000000000000000000000000000000000000000000000001110000000000000000000000000000000000000000000000000000000000000000
0000000000011111000000000000000000000000000000000000000000000000000000000000000010100000000000000000000000000000000000000000000000000000000000000
0000000000001111110110010000000000000000000000000000000000000000000000000000000010001000000000000000000000000000000000000000000000000000000000000
0000000000000111100100000000000000000000000000000000000000000000000000000000000000001000000000000000000000000000000000000000000000000000000000000
0000000000000011111110000000000000000000000000000000000000000000000000000000000000001100000000000000000000000000000000000000000000000000000000000
0000000000000010111111000000000000000000000000100000000000101000000000000000000000001110000000100000000000000000000000000000000000000000000000000
0000000000000000111111100000000000000000000100100000000000000000000000000000000000000000000000000000000000000000000000000000000000000000000000000
0000000000000011111111110000000000000000000000000000000000000000000000000000000000001000000000000000000000000000000000000000000000000000000000000
0000000000001010111111111000000000000000000000000000000000101000000000000000001010001010000000100100000000000000000000000000000000000000000000000
0000000000000000011111111100000000000000001100100000000000001000000000000000000000000000000000000101000000000000000000000000000000000000000000000
0000000000000000001111111110000000000001001100000000000000000000000000000000000000000000000000000000000000000000000000000000000000000000000000000
0000000001001010000111111111000000000000000000000000000000000000000000000000001000000000000000000000000000000000000000000000000000000000000000000
0000000000000000000011111111100000000000001000000000000000001000000000000000101000000000000000000111000000000000000000000000000000000000000000000
0000000000000000000001111111110000100011101100000000000000001000000000000000000000000000000000000001000000000000000000000000000000000000000000000
0000000000000000000000111111111000000001000000000000000000000000000000000000000000000000000000000000000000000000000000000000000000000000000000000
0000000101000000000000011111111100000000000000000000000000000000000000000000101000000000000000000001000000000000000000000000000000000000000000000
0000000000000000000000001111111101100011000000000000000000000000000000000011100000000000000000000001010000000000000000000000000000000000000000000
0000000000000000000000000111111101111011000000000000000000000000000000000000000000000000000000000000000000000000000000000000000000000000000000000
0000000000000000000000000011111110000000000000000000000000000000000000000000000000000000000000000000000000000000000000000000000000000000000000000
0000001100000000000000000001111111000000000000000000000000000000000000000010100000000000000000000000000000000000000000000000000000000000000000000
0000000000000000000000000000001111000000000000000000000000000000000000011000000000000000000000000000000000000000000000000000000000000000000000000
0000000000000000000000000000110111100000000000000000000000000000000000111110100000000000000000000000010000000000000000000000000000000000000000000
0000000000000000000000000100110001111011000000000000000000000010000001110000000000000000000000000000010000000000000000000000000000000000000000000
0000000000000000000000000000010000111110000000000000000000000000000001110000000000000000000000000000000000000000000000000000000000000000000000000
0000000000000000000000000000010000111111000000000000000000000000000000000000000000000000000000000000000000000000000000000000000000000000000000000
0000000000000000000000000000000000011111110000000000000000000000001001000000000000000000000000000000000000000000000000000000000000000000000000000
0000000000000000000000000100110000111111111000000000000000000010001001100000000000000000000000000000010000000000000000000000000000000000000000000
0000000000000000000000100110110000101111111100000000000000000000000000000000000000000000000000000000000000000000000000000000000000000000000000000
0000000000000000000000000100000000000111111110000000000000000000000000000000000000000000000000000000000000000000000000000000000000000000000000000
0000000000000000000000000000000000000111111111000000000000000011011001000000000000000000000000000000000000000000000000000000000000000000000000000
0000000000000000000001101100000000000011111111100000000000001110000000000000000000000000000000000001000000000000000000000000000000000000000000000
0000000000000000001001100100000000000001111111110000000000000000000000000000000000000000000000000000000000000000000000000000000000000000000000000
0000000000000000000000000000000000000000111111111000000000000011000000000000000000000000000000000000000000000000000000000000000000000000000000000
0000000000000000000000000000000000000000011111111101000000001111000000000000000000000000000000000000000000000000000000000000000000000000000000000
0000000000000000011001000000000000000000001111111111000000001000000000000000000000000000000000000000000000000000000000000000000000000000000000000
0000000000000000000000000000000000000000000111111000000000000000000000000000000000000000000000000000000000000000000000000000000000000000000000000
0000000000000000000000000000000000000000000011111100000000000001000000000000000000000000000000000000000000000000000000000000000000000000000000000
0000000000000000000000000000000000000000000001101111000000000000000000000000000000000000000000000000000000000000000000000000000000000000000000000
0000000000000000000000000000000000000000000000100111100000000000000000000000000000000011000000000000000000000000000000000000000000000000000000000
0000000000000000000000000000000000000000000001100111110000111100000000000000000000000010000000000000000000000000000000000000000000000000000000000
0000000000000000000000000000000000000000000000000011111001100000000000000000000000000011000010100000000000000000000000000000000000000000000000000
0000000000000000000000000000000000000000000000000001111101110000000000000000000000000000000000000000000000000001000100000000000000000000000000000
0000000000000000000000000000000000000000000000000000111111000000000000000000000000000001000000000000000000000000000000000000000000000000000000000
0000000000000000000000000000000000000000000000000000011111000000000000000000000000000000000000000000000000000000000000100100100000000000000000000
0000000000000000000000000000000000000000000000000000001111000000000000000000000000010000000001111000000000000000000000000000100010000000000000000
0000000000000000000000000000000000000000000000000000111111110000000000000000000000000000000000111110000000000000001000100000100000000000000000000
0000000000000000010010000000000000000000000000000001110001111000000000000000000000001010000000101110000000000000000000000000000000000000000000000
0000000000000000000000000000000000000000000000000001010001111100000000000000000000000000000000000111100000010011001000000000000000000000000000000
0000000000000000010011001100000000000000001001100001000000111100000000000000000000000000000000000111100000000000000000000000000000000000000000000
0000000000000000000000000000000000000000001001000001000000011110000000000000000000000000000000000001111000010011000000000000000000000000000000000
0000000000000000000000000000000000100010011011000000000000000111001101100000000000000000000000000000111000010000000000000000000000000000000000000
0000000000000000000000000000000000000000010011001000000000000011111000000000000000000000000000000000000000000000000000000000000000000000000000000
0000000000000000000000000000000000000000000000000000000000000001111100000000000000000000000000000000000011000000000000000000000000000000000000000
0000000000000000000000000000000000000000010000000000000000000001111100000000000000000000000000000000000000000000000000000000000000000000000000000
0000000000000000000000000000000000000110010000000000000000000011111111100000000000000000000000000000000000000000000000000000000000000000000000000
0000000000000000000000000000000000000000000000000000000000000010111111100000000000000000000000000000000110000000000000000000000000000000000000000
0000000000000000000000000000000000000000000000000000000000000000001111100000000000000000000000000000000000000000000000000000000000000000000000000
0000000000000000000000000000000000110110010000000000000000000010001111110000000000000000000000000000000000000000000000000000000000000000000000000
0000000000000000000000000000000001110010000000000000000000000010001111111100000000000000000000000000011100000000000000000000000000000000000000000
0000000000000000000000000000000011110000000000000000000000000000000001111000000000000000000000000000010000000000000000000000000000000000000000000
0000000000000000000000000000000011000000000000000000000000000000000000111110000000000000000000000000010000000000000000000000000000000000000000000
1100000000000000000000000000000001000000000000000000000000000000000000101110000000000000000000000000011100100010000000000000000000000000000000000
0110000100000000000000000000100101000000000000000000000000000000000000001111100000000000000000000000110000000000000000000000000000000000000000000
0101000100000000000000000000100000000000000000000000000000000000000000000011110000000000000000000011110000000010001000000000000000000000000000000
0000000111000000000000001001100101000000000000000000000000000000000000000011111000000000000000000011000000000000000000000000000000000000000000000
0001000111000000000000000000000000000000000000000000000000000000000000000001111100000000000000001010000000000000000000000000000100000000100010000
0000000001001000000010011001000000000000000000000000000000000000000000000000111110000000000000001111000000000000000000000000000000000000000000000
0000000011111000000000000000000000000000000000000000000000000000000000000000011111000000000000011100000000000000000000000000000110100000100000000
0000000000001110000010000000000000000000000000000000000000000000000000000000001111111000000000111100000000000000000000000000000010000000000000000
0000000000010000000000000000000000000000000000000000000000000000000000000000000111110000000000010000000000000000000000000000000011000000000000000
0000000000000100000000000000000000000000000000000000000000000000000000000000000011111000000000000000000000000000000000000000000000000000000000000
0000000000000000000000000000000000000000000000000000000010000000000000000000000011111100000001110000000000000000000000000000000000000000000000000
0000000000000011110110000000000000000000000000000000000000100000000000000000000010111110000001110100000000000000000000000000000000000000000000000
0000000000000000110000000000000000000000000000000000000000000000000000000000000000011111001011100000000000000000000000000000000000000000000000000
0000000000000000010010000000000000000000000000000011100000100000000000000000000000001111000011100100000000000000000000000000000000000000000000000
0000000000000000000000000000000000000000000000000010101000000000000000000000000000000111110011000000000000000000000000000000000000000000000000000
0000000000000000000000000000000000000000000000000000000000000000000000000000000000000001110010000000000000000000000000000000000000000000000000000
0000000000000000000000000000000000000000000000000000000000000000000000000000000000000001111110000000000000000000000000000000000000000000000000000
0000000000000000000000000000000000000000000000000000000000000000000000000000000000000100011110000000000000000000000000000000000000000000000000000
0000000000000000000000000000000000000000000000000000000000000000000000000000000000000000011111000000000000000000000000000000000000000000000000000
0000000000000000000000000000000000000000000000000000100000000000000000000000000000000111111111100000000000000000000000000000000000000000000000000
0000000000000000000000000000000000000000000000000000000010000000000000000000000000011111000111110000000000000000000000000000000000000000000000000
0000000000000000010010000000000000000000000000000000100011100000000000000000000010011110000011111100000000000000000000000000000000000000000000000
0000000000000000000000000000000000000000000000000000000011000000000000000000000111011000000001111100000000000000000000000000100111000000000000000
0000000000000000000000000000000000000000000000000000000011100000000000000000011110000000000000111110000000000000000000100000100110000000000000000
0000000000000000000011001000000000000000000000000000000001111000000000000000001110001010000000111111000000000000000000000000000000000000000000000
0000000000000000000000001000000000000000000000000000000001111000000000000001111000000000000000001111100000000000001000000000000000000000000000000
0000000000000000000001001101100000000000001000000000000000011100000000000001101000000000000000000111110000000000000000000000000000000000000000000
0000000000000000000000000000000000000000000000000000000000011110000000000011000000000000000000000011111000010011000000000000000000000000000000000
0000000000000000000000000000100001100010000000000000000000000110000000111111000000000000000000000001111000000000000000000000000000000000000000000
0000000000000000000000000000000000000000000000000000000000000110000000100100000000000000000000000000111111110010000000000000000000000000000000000
0000000000000000000000000000000000000000000000000000000000000000000100100100000000000000000000000000001110100000000000000000000000000000000000000
0000000000000000000000000000000000000000000000000000000000000000100100000000000000000000000000000000001111100000000000000000000000000000000000000
0000000000000000000000000000000000000000000000000000000000000000100000000000000000000000000000000000001011111000000000000000000000000000000000000
1000000000000000000000000000000000000000000000000000000000000000000000000100000000000000000000000000001111111110000000000000000000000000000000000
0000000000000000000000000000000000000000000000000000000000010110000000000000000000000000000000000000101001111111000000000000000000000000000000000
0000000000000000000000000000000000000000000000000000000000000000000000000000000000000000000000000000000001111111100000000000000000000000000000000
1000000000000000000000000000000000000000000000000000000000000000000000000000000000000000000000000000000000111111110000000000000000000000000000000
1100000000000000000000000000000000000000000000000000000000010100000000000101000000000000000000000000101000111111111000000000000000000000000000000
0000000000000000000000000000000000000000000000000000010000010100000000000000000000000000000000000000100000011111111100000000000000000000000000000
0000000000000000000000000000000000000000000000000000000000000000000000000000000000000000000000000000000000001111111110000000000000000000000000000
1100000000000000000000000000000000000000000000000000000000000000000000000000000000000000000000000000000000000111111111000000000000000000000000011
0000000000000000000000000000000000000000000000000000000001010000000000000001000000000000000000000010000000000011111111100000000000000000000000010
0000000000000000000000000000000000000000000000000000010000000000000000000000000000000000000000000000000000000001111111110000000000000000000000000
0000000000000000000000000000000000000000000000000000000000000000000000000000000000000000000000000000000000000000111111110000000000000000000000011
0000000000000000000000000000000000000000000000000000000000000000000000000000000000000000000000000000000000000000011111110001000000000000000010111
0000000000000000000000000000000000000000000000000000000101000000000000000000000000000000000000001000000000000000001111111001100100000000000000000
0000000000000000000000000000000000000000000000000000000000000000000000000000000000000000000000000000000000000000000111111001000000000000000000000
0000000000000000000000000000000000000000000000000000000000000000000000000000000000000000000000000000000000000000000000111111100000000000000000000
0000000000000000000000000000000000000000000000000000000100000000000000000000000000000000000000000000000000000000000000001111110000000000000000000
0000000000000000000000000000000000000000000000000000000000000000000000000000000000000000000000000000000000000000000000001111111000000000000000000
0000000000000000000000000000000000000000000000000000000000000000000000000000000000000000000000000000000000000000000001111111111100000000000100000
0000000000000000000000000000000000000000000000000000000111000000000000000000000000000000000000011000000000000000000000101111111110000000000000000
0000000000000000000000000000000000000000000000000000000000000000000000000000000000000000000000000000000000000000000000000111111111000000000000000
0000000000000000000000000000000000000000000000000000000000000000000000000000000000000000000000000000000000000000000000000011111111100001000100000
0000000000000000000000000000000000000000000000000000000000000000000000000000010100000000000000011000000000000000000000100001111111100001100110000
0000000000000000000000000000000000000000000000000000000010000000000000000000000111000000000000011000000000000000000000000000111111100000000000000
0000000000000000000000000000000000000000000000000000000000000000000000000000000001000000000000010000000000000000000000000000011111110000000000000
0000000000100000000000000000000000000000000000000000000000000000000000000000000100000000000000000000000000000000000000000000001111111001100100000
0000000000110000000000000000000000000000000000000000000000000000000000000000000000000000000000000000000000000000000000000000000001111000000000000
0000000000100000000000000000000000000000000000000000000000000000000000000000000000000000000000000000000000000000000000000000000000111111100000000
0000110010100000000000000000000000000000000000000000000000000000000000000000000000000000000000000000000000000000000000000000000000001111110000000
0000000000000000000000000000000000000000000000000000000000000000000000000000000000000000000000000000000000000000000000000000000000001111111000000
0000000000000000000000000000000000000000000000000000000000000000000000000000000000000000000000000000000000000000000000000000001100101111111100000
0001000010100000000000000000000000000000000000000000000000000000000000000000010100000000000000000000000000000000000000000000000100101111111110000
0001100010000000000000000000000000000000000000000000000000000000000000000000000000000000000000000000000000000000000000000000000000000111111111000
0000000000000000000000000000000000000000000000000000000000000000000000000000000000000000000000000000000000000000000000000000000000000011111111000
0000000000000000000000000000000000000000000000000000000000000000000000000000000000000000000000000000000000000000000000000001001100100001111111100
0001000000000000000000000000000000000000000000000000000000000000000000000000010000000000000000000000000000000000000001000000000100000000111111110
0000000000000000000000000000000000000000000000000000000000000000000000000000000000000000000000000000000000000000000000000000000000000000011111110
0000000000000000000000000000000000000000000000000000000000000000000000000000000000000000000000000000000000000000000001000000000000000000000111111
0000000000000000000000000000000000000000000000000000000000000000000000000000000000000000000000000000000000000000011011000000000000000000000011111
0000000000000000000000000000000000000000000000000000000000000000000000000000000000000000000000000000000000000000010011000000000000000000000000111