92 sites
11001100000000000000000000000000000000000000000000000000000000000000000000000000000000000000
11111100000000000000000000000000000000000000000000000000000000000000000000000000000000000000
01111110000000000000000000000000000000000000000000000000000000000000000000000000000000000000
01111111000000000000000000000000000000000000000000000000000000000000000000000000000000000000
11111111100000000000000000000000000000000000000000000000000000000000000000000000000000000000
11111111110000000000000000000000000000000000000000000000000000000000000000000000000000000000
00111111111000000000000000000000000000000000000000000000000000000000000000000000000000000000
00011111111100000000000000000000000000000000000000000000000000000000000000000000000000000000
00001111111110000000000000000000000000000000000000000000000000000000000000000000000000000000
00000111111111000000000000000000000000000000000000000000000000000000000000000000000000000000
00000011111111100000000000000000000000000000000000000000000000000000000100100000000000000000
00000001111111110000000000000000000000000000000000000000000000000001000000000000000000000000
00000000111111111000000000000000000000000000000000000000000000000000000000000000000000000000
00000000011111111100000000000000100010000000000000000000000000000000000000000000000000000000
00000000001111111110000010000000100000000000000000000000000000000001001000000000000000000000
00000000000111111111001000000000000000000000000000000000000000000000000000000000000000000000
00000000000011111111000000000000000000000000000000000000000000000000000000000000000000000000
00000000000001111111000010001101100000000000000000000000000000000000000000000000000000000000
00000000000000111111011110001000000000000000000000000000000000000000000000000000000000000000
00000000000000011111110000001000000000000000000000000000000000000000000000000000000000000000
00000000000000000001111000000000000000000000000000000000000000000000000000000000000000000000
00000000000000000011111100000000000000000000000000000000000000000000000000000000000000000000
00000000000000010010111100000000000000000000000000000000000000000010000000000000000000000000
00000000000000000010011111000000000000000000000000000000000000001110000000000000000000000000
00000000000000100110000111101100100000000000000000000000000000001100001000000000000000000000
00000000000000000000000111111100000000000000000000000000000000011100000000000000000000000000
00000000000000000000000011111110000000000000000000110010000000010000000000000000000000000000
00000000000000000000000001111111000000000000000000000000000000000000000000000000000000000000
00000000000000000111000011111111100000000000000000000000000000000000000000000000000000000000
00000000000000000100000011111111110000000000000000100110010000000100000000000000000000000000
00000000000000000000000000111111111000000000000000100000000000000000000000000000000000000000
00000000000000000100000000011111111100000000000000000000000000000000000000000000000000000000
00000000000001100100000010001111111111000000000000000000000000000000000000000000000000000000
00000000000000000000000000000111111111001100000000100100000000000000000000000000000000000000
00000000000000000000000000000011111110100100000000000000000000000000000000000000000000000000
00000000000000000000000000000001111110100000000000000000000000000000000000000000000000000000
00000000000001000000000000000000111111100000000000000000000000000000000000000000000000000000
00000000000000000000000000000000110011111100000000000000000000000000000000000100000000000000
00000000000000000000000000000000001111111110000000000000000000000000000000000000000000000000
00000000000000000000000000000000000001111111000000000000000000000000000000000000000000000000
00000000000000000000000000000000010001111111100001000000000000000000000000000100000000000000
00000000000000000000000000000000011001111111100001000000000000000000000000000000000000000000
00000000000000000000000000000000000000111111010000000000000000000000000000000000000000000000
00000000000000000000000000000000000000011111110000000000000000000000000000000000000000000000
00000000000000000000000000000000000000001101111001000000000000000000000000000000000000000000
00000000000000000000000000000000000000000011111100000000000000000000000000000000000000000000
00000000000000000000000000000000000000000000111111001000000000000000000000000000000000000000
00000000000000000000000000000000000000000000011111000000000000000000000000000000000000000000
00000000000000000000000000000000000000000000001111111000000000000000000000000000000000000000
00000000000000000000000000000000000000001100101111111100000000000000000000000000000000000000
00000000000000000000000000100110010000000000000011111110000000000000000000000000000000000000
00000000000000000000000000100000000000000000000011111111000000000000000000000000000000000000
00000000000000000000000000000000000000000000001011111111100000000000000000000000000000000000
00000000000000000000000000000100010000000000000001111111110000000000000001000000000000000000
00000000000000000000000000100100000000000000000000111111111000000100000000000000000000000000
00000000000000000000000000000000000000000000000000011111111000000000000000000000000000000000
00000000000000000000000000000000000000000000000000001111111000000000000000000000000000000000
00000000000000000000000000000100000000000000000000000111111100000100011011000000000000000000
00000000000000000000000000000000000000000000000000000011111111111100010000000000000000000000
00000000000000000000000000000000000000000000000000000000011111000000010000000000000000000000
00000000000000000000000000000000000000000000000000000000001111101000000000000000000000000000
00000000000000000000000000000000000000000000000000000000001111100000000000000000000000000000
00000000000000000000000000000000000000000000000000000000001011111000000000000000000000000000
00000000000000000000000001100000000000000000000000000000001000111000000000000000000000000000
00000000000000000000000111000000000000000000000000000000001010111110000000000000000000000000
00000000000000000000000111000100000000000000000000000010011000001110011000000000000000000000
00000000000000000000001100000000000000000000000000000000000000001111111000000000000000000000
00000000000100100000000000000000000000000000000000000000000000000011111100000000000000000000
00000000000000000000000000000000000000000000000000000000000000000011111110000000000000000000
00000000000000000000000000000000000000000000000000000000011100000111111111000000000000000000
00000000000000100000000010000000000000000000000000000000010000000111111111100000000000000000
00000000001000000000000000000000000000000000000000000000000000000001111111110000000000000000
00000000000000000000000000000000000000000000000000000000010000000000111111111000000000000000
00000000000000000000000000000000000000000000000000000100010000000000011111111100000000000000
00000000001000000000000000000000000000000000000000000000000000000000001111111110000000000000
00000000000000000000000000000000000000000000000000000000000000000000000111111111000000000000
00000000000000000000000000000000000000000000000000000000000000000000000011111111100000000000
00000000000000000000000000000000000001001000000000000000000000000000000001111111110000000000
00000000000000000000000000000000000000000000000000000000000000000000000000111111111000000000
00000000000000000000000000000000000000000000000000000000000000000000000000011111111100000000
00000000000000000000000000000000000000000000000000000000000000000000000000001111111110000000
00000000000000000000000000000000000000000000000000000000000000000000000000000111111111000000
00000000000000000000000000000000000000000000000000000000000000000000000000000011111111100000
00000000000000000000000000000000000000000000000000000000000000000000000000000001111111110000
00000000000000000000000000000000000000000000000000000000000000000000000000000000111111111000
00000000000000000000000000000000000000000000000000000000000000000000000000000000011111111100
00000000000000000000000000000000000000000000000000000000000000000000000000000000001111111100
00000000000000000000000000000000000000000000000000000000000000000000000000000000000111111100
00000000000000000000000000000000000000000000000000000000000000000000000000000000000011111110
00000000000000000000000000000000000000000000000000000000000000000000000000000000000001111110
00000000000000000000000000000000000000000000000000000000000000000000000000000000000000001111
00000000000000000000000000000000000000000000000000000000000000000000000000000000000000000011