150 sites
111000000000000000000000000000000000000000000000000000000000000000000000000000000000000000000000000000000000000000000000000000010111000000000000000000
111100000000000000000000000000000000000000000000000000000000000000000000000000000000000000000000000000000000000000000000000000000011110000000000000000
111110000000000000000000000000000000000000000000000000000000000000000000000000000000000000000000000000000000000000000000000000100011110000000000000000
011111000000000000000000000000000000000000000000000000000000000000000000000000000000000000000000000000000000000000000000000000000000010000100000000000
001111001100000000000000000000000000000000000000000000000000000000000000000000000000000000000000000000000000001000000000000000000000111100000000000000
000111111100000000000000000000000000000000000000000000000000000000000000000000000000000000000000000000000000000000000000000000000000000100000000000000
000001111110000000000000000000000000000000000000000000000000000000000000000000000000000000000000000000000000000000000000000000000000000100000000000000
000001111111000000000000000000000000000000000000000000000000000000000000000000000000000000000000000000000000000000000000000000000000000000000000000000
000011111111100000000000000000000000000000000000000000000000000000000000000000000000000000000000000000000000000000000000000000000000000000000000000000
000011111111110000000000000000000000001100100000000000000000000000000000000000000000000000000000000000000000010000000000000000000000001100000000000000
000000111111111000000000000000000000000000100000000000000000000000000000000000000000000000000000000000000000000000000000000000000000000000000000000000
000000011111111100000000000000000000000000000000000000000000000000000000000000000000000000000000000000000000000000000000000000000000000000000000000000
000000001111111110000000000000000000000000000000000000000000000000000000000000000000000000000000000000000000011000000000000110000000000000000000000000
000000000111111111000000000000000000000100110010000000000000000000000000000000000000000000000000000000000000010000000000000100000000000000000000000000
000000000011111111100000000000000000000000100010000000000000000000000000000000000000000000000000000000000000000000000000000000000000000000000000000000
000000000001111111110000000000000000000000000000000000000000000000000000000000000000000000000000000000000000000000000000000100000000000000000000000000
000000000000111111111000000000000000000100010000000000000000000000000000000000000000000000000000000000000001010000000000011100000000000000000000000000
000000000000011111111100000000000000000000110011000000000000000000000000000000000000000000000000000000000000000000000000000000000000000000000000000000
000000000000001111111100000000000000000000000010000000000000000000000000000000000000000000000000000000000000000000000000000000000000000000000000000000
000000000000000111111100000000000000000000000000000000000000000000000000000000000000000000000000000000000000000000000000010000000000000000000000000000
000000000000000011111101001000000000000000010001000000000000000000000000000000000010000000000000000000000101000000000000000000000000000000000000000000
000000000000000001111111000000000000000000000001000000000000000000000000000000000000000000000000000000000000000000000000000000000000000000000000000000
000000000000000000000111110000000000000000000000000000000000000000000000000000000000000000000000000000000000000000000000000000000000000000000000000000
000000000000000000001111111000000000000000000001110000000000000000000000000000000000000000000000000000000000000000000000000000000000000000000000000000
000000000000000000000011111000000000000000000000000000000000000000000000000000000000000000000000000000000000000000000000000000000000000000000000000000
000000000000000000000011111000000000000000000000000000000000000000000000000000001000000000000000000000000000000000000000000000000000000000000000000000
000000000000000000001001111111000000000000000001010000000000000000000000000000001110000000000000000000000000000000000000000000000000000000000000000000
000000000000000000000000001110000000000000000000000100000000000000000000000000011100000000000000000000000000000000000000000000000000000000000000000000
000000000000000000000000001111100000000000000000010111000000000000000000000000001110000000000000000000000000000000000000000000000000000000000000000000
000000000000000000000000001011110000000010011001010111000000000000000000000000000111100000000000000000000000000000000000000000000000000000000000000000
000000000000000000000000000011111000000010000000000011110000000000000000001000100111100000000000000001001000000000000000000000000000000000000000000000
000000000000000000000000000001111100110111000000000011110000000000000000000000000001110000000000000000000000000000000000000000000000000000000000000000
000000000000000000000000000000111101100000000000000000110100000000000000000000000001111000000100010000000000000000000000000000000000000000000000000000
000000000000000000000000000000011111110000000000000000111100000000000000100000000000000000000000000000000000000000000000000000000000000000000000000000
000000000000000000000000000000000111110000000000000000000000000000000000000000000000000000000000000000000000000000000000000000000000000010000000000000
000000000000000000000000000000001111111100000000000000000000000000000000000000000000011100000000000000000000000000000000000000000000001000000000000000
000000000000000000000000000000011111111110000000000000100000000000000000000000000001111000000000000000000000000000000000000000000000000000000000000000
000000000000000000000000000000010111111111000000000000100000000000000000000000000000000000000000000000000000000000000000000000000000000000000000000000
000000000100000000000000000000000001111111100000000000000000000000000000000000000000001000000000000000000000000000000000000000000000000110000000000000
000000000100010010000000000000010001111111110000000000000000000000000000000000000000111000000000000000000000110000000000000000000000000000000000000000
000000000000000000000000000001110000111111111000000010100000000000000000000000000000100000000000000000000000000000000000000000000000000000000000000000
000000000000000000000000000000010000011111111100000010000000000000000000000000000000000000000000000000000000000000000000000000000000000000000000000000
000000000110011001000000000000000000001111111110000000000000000000000000000000000000000000000000000000000000000000000000000000000000000000000000000000
000000000000010011001000000001000000000111111111010000000000000000000000000000000010100000000000000000000000000000000000000000000000000000000000000000
000000000000000000000000000001000000000011111111111010000000000000000000000000000000000000000000000000000000000000000000000000000000000000000000000000
000000000000000000000000000000000000000001111111100000000000000000000000000000000000000000000000000000000000000000000000000000000000000000000000000000
000000000000011001100000000000000000000000111111100000000000000000000000000000000000000000000000000000000000000000000000000000000000000000000000000000
000000000000000001001101001001000000000000011111110000000000000000000000000000000000000000000000000000000000000000000000000000000000000000000000000000
000000000000000000000001000000000000000000001111111000000000000000000000000000000000000000000000000000000000000000000000000000000000000000000000000000
000000000000000000000001001011000000000000011001111110000000000000000000000000000000000000000000000000000000000000000000000000000000000000000000000000
000000000000000000000000000000000000000000001000111110000000000000000000000000000000000000000000000000000000000000000000000000000000000000000000000000
000000000000000000000000000111000000000000000000011111000000000000000000000000000000000000000000000000000000000000000000000000000000000000000000000000
000000000000000000000000000011110000000011001000011111100000000000000000000000000000000000000000000000000000000000000000000000000000000000000000000000
000000000000000000000000000011110000000000000000000111110000000000000000001000000000000000000000000000000000000000000000000000000000000000000000000000
000000000000000000000000000000111100110010000000000011111000000000000000101000000000000000000000000000000000000000000000000000000000000000000000000000
000000000000000000000000000000111100000000000000000001111100000000000010111000000001000000000000010011000000000000000000000000000000000000000000000000
000000000000000000000000000000000100000000000000000000111110000000000011110000000000000000000000000000000000000000000000000000000000000000000000000000
000000000000000000000000000000001100000000000000000000011111000000001111010000000000000000000100110000000000000000000000000000000000000000000000000000
000000000000000000000000000000000000000000000000000000001111100000001111000000000000000000000000000000000000000000000000000000000000000000000000000000
000000000000000000000000000000000000000000000000000000000111110000101000000000000000000000001100000000000000000000000000000000000000000000000000000000
000000000000000000000000000000000000000000000000000000000011111000111100000000000000000000000000000000000000000000000000000000000000000000000000000000
000000000000000000000000000000000000000000000000000000000001111100100000000000000000000000000000000000000000000000000000000000000000000000000000000000
000000000000000000000000000000000000000000000000000000000000111101110000000000000000000000000000000000000000000000000000000000000000000000000000000000
000000000000000000000000000000000000000000000000000000000000011111000000000000000000000000000000000000000000000000000000000000000000000000000000000000
000000000000000000000000000000000000000000000000000000000000000111000000000000000000000000000000000000000000000000000000000000000000000000000000000000
000000000000000000000000000000000000000000000000000000000000001111110000000000000000000000000000000000000000000000000000000000000000000000000000000000
000000000000000000000000000000000000000000000000000000000001111001111000000000000000000000001000000000000000000000000000000000000000000000000000000000
000000000000000000000000000000000000000000000000000000000000101001111100000000000000000000000000000000000000000000000000000000000000000000000000000000
000000000000000000000000000000000000000000000000000000000111100000111110000000000000000000000000100000000000000000000000000000000000000000000000000000
000000000000000000000000000000000000000000000000000000000110100000011111000000000000000000000000000000000000000000000000000000000000000000000000000000
000000000000000000000000000000000000000000000000000000011110000000001111110000000000000000000000000010000000000000000000000000000000000000000000000000
000000000000000000000000000000000000000000000000000000001110000000000111100000000000000000000000000000000000000000000000000000000000000000000000000000
000000000000000000000000000000000100000000000000000000111000000000000011110000000000000000000000000000000000000000000000000000000000000000000000000000
000000000000000000000000000000000000000000000000000000011100000000000010111100000000000000000000000010000000000000000000000000000000000000000000000000
000000000000000000000000000000100000000000000000000001110000000000000000011110100100000000000000000001000000000000000000000000000000000000000000000000
000000000000000000000000000000000000000000000000000000000000000000000000011110000000000000000000000000000000000000000000000000000000000000000000000000
000000000000000000000000000000000000000000000000000000000000000000000000001111110100000000000000000001000000000000000000000000000000000000000000000000
000000000000000000000000000000000000000000000000000000000000000000000000000011110000000000000000000001111000000000000000000000000000000000000000000000
000000000000000000000000000000100000000000000000000000000000000000000000001011111101000000000000000011111100000000000000000000000000000000000000000000
000000000000000000000000000100000000000000000000000000000000000000000000000011111100000000000000000000011000000000000000000000000000000000000000000000
000000000000000000000000011110000000000000000000000000000000000000000000000000111100000000000000000000010000000000000000000000000000000000000000000000
000000000000000000000000001111100000000000000000000000000000000000000000001010111111000000000000000001001100000000000000000000000000000000000000000000
000000000000000000001000001011100000000000010000000000000000000000000000000000000111100000000000000000001101000000000000000000000000000000000000000000
000000000000000000000000000001111000100000000000000000010000000000000000000000100111110000000000010001001111000000000000000000000000000000000000000000
000000000000000000000000000001111000100110010000000000000000000000000000000000000011110000000000000000000011100000000000000000000000000000000000000000
000000000000000000000000000000011001100100000000000000000000000000000000000000000001111110000110010000000011100000000000000000000000000000000000000000
000000000000000000000000000000001001101100000000000000000000000000000000000000000000011100000000000000000000111000000000000000000000101000000000000000
000000000000000000000000000000000001000000000000000000000000000000000000000000000000011111000000000000000000111110010000000000100000100000000000000000
000000000000000000000000000000000000000000000000000000000000000000000000000000000000010111110110000000000000101110111011001000000000000000000000000000
000000000000000000000000000000000000000000000000000000000000000000000000000000000000000111111000000000000000000010110000000000000000000000000000000000
000000000000000000000000000000000000000000000000000000000000000000000000000000000000000011111000000000000000000010110000000000000000000000000000000000
000000000000000000000000000000000000000000000000000000000000000000000000000000000000000011111111000000000000000000110110000000000000000000000000000000
000000000000000000000000000000000000000000000000000000000001000000100000000000000000000001111111100000000000000000000000000000000000000000000000000000
000000000000000000000000000000001000000000000000000000000101000000000000000000000000010010011111110000000000000000000000000000000000000000000000000000
000000000000000000000000000000000000000000000000000000000000000000000000000000000000010010011111111000000010000000010011000000000000000000000000000000
000000000000000000000000000000000000000000000000000000000000000000000000000000000000000000011111111100000000000000000010000000000000000000000000000000
000000000000000000000000000000000000000000000000000000000100000000001000000000000000000000001111111110000000000000000000000000000000000000000000000000
000000000000000000000000000000001000000000000000000000010100000000000000000000000001010000000111111111001010000000000000000000000000000000000000000000
000000000000000000000000000000000000000000000000000000000000000000000000000000000000000000000011111111101010000000000010000000000000000000000000000000
000000000000000000000000000000000000000000000000000000000000000000000000000000000000000000000001111110100000000000000000000000000000000000000000000000
000000000000000000000000000000000000000000000000000000010000000000000010010000100000000000000000111111100000000000000000000000000000000000000000000000
000000000000000000000000000000100000000000000000000000010000000000000000001011100101000000000000011011111010000000000000000000000000000000000000000000
000000000000000000000000000000000000000000000000000000000000000000000000000001100000000000000000001111111000000000000000000000000000000000000000000000
000000000000000000000000000000000000000000000000000000000000000000000000000001111000000000000000000001111000000000000000000000000000000000000000000000
000000000000000000000000000000100000000000000000000000000000000000000000000001110111000000000000011001111110000000000000000000000000000000000000000000
000000000000000000001000000000000000000000000000000000000000000000000000000000100111000000000000000000001111000000000000110000000000000000000000000000
000000000000000000000000000000000000000000000000000000000000000000000000000000000001110000000010011001001111100000000011100000000000000000000000000000
000000000000000010001000000000000000000000000000000000000000000000000000000000000011110000000000000000000111100000000001111000000000000000000000000000
000000000000000000000000000000000000000100000000000000000000000000000000000000000000111110000000000000000011111100000001011100000000000000000000000000
000000000100110010000000000000000000000100000000000000000000000000000000000000000000001100000000000000000000111000000000001110000000000000000000000000
000010000000100000000000000000000000000000000000000000000000000000000000000000000000001110000000000000000000111110000000001110100000100000000000000000
000000000000000000000000000000000000000000000000000000000000000000000000000000000000000110000000000000000000101111011001001011100000000000000000000000
000000000000000000000000000000000000000000000000000000000000000000000000000000000000000111100000000000000000001111111000000000111010000000000000000000
000000000000000000000000000000000000000000000000000000000000000000000000000000000000000000000000000000000000000111111000000000011000000000000000000000
000000000000000000000000000000000000000000000000000000000000000000000000000000000000000011110000000000000000000011111000000000001000000000000000000000
000000000000000000000000000000000000000000000000000000000000000000000000000000000000000111110010000000000000000111111111000000000000000000000000000000
000000000000000000000000000000000000000000000000000000000000000000000000000000000000000010000000000000000000000111111111001001000000000000000000000000
000000000000000000000000000000000000000000000000000000000000000000000000000000000000000000010000000000000000000000011111000000000000000000000000000000
000000000000000000000000000000000000000000000000000000000000000000000000000000000000000010010011001000000010000000011111000000000000000000000000000000
000000000000000000000000000000000000000000000000000000000000000000000000000000000000000010000010000000000011100100011111111000000000000000000000000000
000000000000000000000000000000000000000000000000000000000000000000000000000000000000000000000000000000000111000000000001110000000000000000000000000000
000000000000000010010000000000000000000000000000000000000000000000000000000000000000000000000000000000000101100000000001111100000000000000000000000000
000000000000000010000000000000000000000000000000000000000000000000000000000000000000000010000000000000000001111100001001011111000000000000000000000000
000000000000110110000000000000000000000000000000000000000000000000000000000000000000000000000000000000000000111000000000011110000000000000000000000000
000000000000100000000000000000000000000000000000000000000000000000000000000000000000000000000000000000000000011100000000001111100000000000000000000000
000000000000000000000000000000000000000000000000000000000000000000000000000000000000000000000000000000000000000100001000001011110000000000000000000000
001000000000000000000000000000000000000000000000000000000000000000000000000000000000000100000000000000000000001110000000000011111010100000000000000000
100000000000000000000000000000000000000000000000000000000000000000000000000000000000000000000000000000000000000011000000000001111110000000000000000000
000000000000000000000000000000000000000000000000000000000000000000000000000000000000000000000000000000000000000011100000000000111110000000000000000000
100000000000000000000000000000000000000000000000000000000000000000000000000000000000000000000000000000000000000000000000000000011110000000000000000000
111000000000000000000000000000000000000000000000000000000000000000000000000000000000000000000000000000000000000010000000000000111111100000000000000000
111000000000000000000000000000000000000000000000000000000000000000000000000000000000000000000000000000000000000000000000000000000011110000000000000000
011010000000000000000000000000000000000000000000000000000000000000000000000000000000001100000000000000000000001000000000000000100011111000000000000000
011110000000000000000000000000000000000000000000000000000000000000000000000000000000000000000000000000000000000000000000000000000001111001100000000000
000010000100000000000000000000000001000000000000000000000000000000000000000000000000001000000000000000000000000000000000000000000000111111100000000000
000011100100000000000000000000000000001000000000000000000000000000000000000000000000000000000000000000000000000000000000000000000000001111100000000000
000000000000000000000000000000000010001000000000000000000000000000000000000000000000000000000000000000000000000000000000000000000000001111100000000000
000000000000000000000000000000000000000000000000000000000000000000000000000000000000000000000000000000000000000000000000000000000000011111100000000000
000100000000000000000000000000000000000000000000000000000000000000000000000000000000000000000000000000000000000000000000000000000000011111110000000000
000000000000000000000000000000000000000000000000000000000000000000000000000000000000000000000000000000000000000000000000000000000000000000111100000000
000000000000000000000000000000000000000000000000000000000000000000000000000000000000000000000000000000000000000000000000000000000000000000011100000000
000000000000000000000000000000000000000000000000000000000000000000000000000000000000000000000000000000000000000000000000000000000000000000011111000000
000000000000000000000000000000000000000000000000000000000000000000000000000000000000000000000000000000000000000000000000000000000000000000000111100000
000000000000000000000000000000000000000000000000000000000000000000000000000000000000000000000000000000000000000000000000000000000000000000000111110000
000000000000000000000000000000000000000000000000000000000000000000000000000000000000000000000000000000000000000000000000000000000000000000000011110000
000000000000000000000000000000000000000000000000000000000000000000000000000000000000000000000000000000000000000000000000000000000000000000000001111110
000000000000000000000000000000000000000000000000000000000000000000000000000000000000000000000000000000000000000000000000000000000000000000000000011100
000000000000000000000000000000000000000000000000000000000000000000000000000000000000000000000000000000000000000000000000000000000000000000000000011111
000000000000000000000000000000000000000000000000000000000000000000000000000000000000000000000000000000000000000000000000000000000000000000000000010111
000000000000000000000000000000000000000000000000000000000000000000000000000000000000000000000000000000000000000000000000000000000000000000000000000111