117 sites
111110000000000000000000000000000000000000000000000000000000000000000000000000000000000000000000000000000000000000000
111111010000000000000000000000000000000000000000000000000000000000000000000000000000000000000000000000000001000100000
111111010000000000000000000000000000000000000000000000000000000000000000000000000000000000000000000000000000000000000
111110000000000000000000000000000000000000000000000000000000000000000110000000000000000000000000000000000000000000000
111111000000000000000000000000000000000000000000000000000000000000001110000000000000000000000000000000001001100000000
011011110010000000000000000000000000000000000000000000000000000000011110000000000000000000000000000000001001100100000
000001111110000000000000000000000000000000000000000000000000000010011100100000000000000000000000000000000000000000000
011001111111000000000000000000000000000000000000000000000000000000010000000000000000000000000000000000000000000000000
000000111111100000000000000000000000000000000000000000000000000000000000000000000000000000000000000000000000000000000
000000111111110000000000000000000000000000000000000000000000000000010000000000000000000000000000000000000000000000000
000001111111111000000010000000000000000000000000000000000000000000010000000000000000000000000000000000000000100110010
000000011111111100000000000000000000000000000000000000000000000000000000000000000000000000000000000000000000000000010
000000001111111110000000000000000000000000000000000000000000000000000000000000000000000000000000000000000000000000000
000000000111111111100110000000000000000000000000000000000000000000010000000000000000000000000000000000000000000000000
000000000011111111110010000000000000000000000000000000000000000000000000000000000000000000000000000000000000000010011
000000000001111110000000000000000000000000000000000000000000000000000000000000000000000000000000000000000000000000000
000000000000111111000000000000000000000000000000000000000000000000000000000000000000000000000000000000000000000000000
000000000000011011101110000000000000000000000000000000000000000000000000000000000000000000000000000000000000000000000
000000000000011001111110000000000000000000000000000000000000000000000000000000000000000000000000000000000000000000000
000000000000001000111111000000000000000000000000000000000000000000000000000000000000000000000000000000000000000010011
000000000000000001111111100000000000000000000000000000000000000000000000000000000000000000000000000000000000000000000
000000000000010001111111110000000000000000000000000000000000000000000000000000000000000000000000000000000000000000000
000000000010011001111111111000000000000000000000000000000000000000110000000000000000000000000000000000000000000010000
000000000000000000011111111100000000000000000000000000000000000000000000000000000000000000000000000000000000010010000
000000000000000000001111111110000000000000000000000000000000000000000000000000000000000000000000000000000000000000000
000000000000000000000111111111000000000000000000000000000000000001100000000000000000000000000000000000000000000000000
000000000000000000000011111111100000000000000000000000000000000000100000000000000000000000000000000000000100110010000
000000000000000000000001111111110000000000000000000000000000000000000000000000000000000000000000000000000000000000000
000000000000000000000000111111111000000000000000000000000000000000000000000000000000000000000000000000000000000000000
000000000000000000000000011111111100000000000000000000000000001101101000000000000000000000000000000000000100000000000
000000000000000000000000001111111100000000000000000000000000000000000000000000000000000000000000000000100100000000000
000000000000000000000000000111111110000000000000000000000000000000000000000000000000000000000000000000000000000000000
000000000000000000000000000011111111100000000000000000000000001000000000000000000000000000000000000000000000000000000
000000000000000000000000000001111111110000000000000000000001001000000000000000000000000000000000000001100100000000000
000000000000000000000000000000011111111000000000000000000000000000000000000000000000000000000000000000000000000000000
000000000000000000000000000000001111111100000000000000000000000000000000000000000000000000000000000000000000000000000
000000000000000000000000000000001111111110000000000000010011001000000000000000000000000000000000000000000000000000000
000000000000000000000000000000000111111111000000000000000000000000000000000000000000000000000010011001000000000000000
000000000000000000000000000000000011111111100000000000000000000000000000000000000000000000000000000000000000000000000
000000000000000000000000000000000001111111110000000100010000000000000000000000000000000000000000000000000000000000000
000000000000000000000000000000000000111111111000000010011001000000000000000000100000000000000010011000000000000000000
000000000000000000000000000000000000011111111100000000000000000000000000000000000000000000000010001000000000000000000
000000000000000000000000000000000000001111111110100100000000000000000000000000000000000000000000000000000000000000000
000000000000000000000000000000000000000111111110100110010000000000000000000000000000000000000000000000000000000000000
000000000000000000000000000000000000000011111111100010000000000000000000000000000000000000110010000000000000000000000
000000000000000000000000000000000000000001111111000000000000000000000000000000000000000000000000000000000000000000000
000000000000000000000000000000000000000000111111100100000000000000000000000000000000000000000000000000000000000000000
000000000000000000000000000000000000000000001111110000000000000000000000000000000000000000000000000000000000000000000
000000000000000000000000000000000000000000111011111110000000000000000000000000000000000000000000000000000000000000000
000000000000000000000000000000000000000000000001111111000000000000000000000000000100000000000000000000000000000000000
000000000000000000000000000000000000000000000000111111100000000000000000000000000000000000000000000000000000000000000
000000000000000000000000000000000000000100110010111111110000000000000000000000000000000000000000000000000000000000000
000000000000000000000000000000000000000010011000111111111000000000000000000000100000000000100010000000000000000000000
000000000000000000000000000000000000000000000000011111111100000000000000000000111100000000000000000000000000000000000
000000000000000000000000000000000000000000000000001111111110000000000000000000010000000000000000000000000000000000000
000000000000000000000000000000000000100110010000000111111111000000000000000000100000000000000000000000000000000000000
000000000000000000000000000000000000000010000000000011111111100000000000000111110000000000000000000000000000000000000
000000000000000000000000000000000000000000000000000001111111110000000000000100010000000000000000000000000000000000000
000000000000000000000000000000000000100000000000000000111111111000000000000000000000000000000000000000000000000000000
000000000000000000000000000000000100100010000000000000011111111100000001001100100000000000000000010000000000000000000
000000000000000000000000000000000000000000000000000000001111111110000000100110110000000000000000000000000000000000000
000000000000000000000000000000000000000000000000000000000111111111000000000100000000000000000000000000000000000000000
000000000000000000000000000001001100100000000000000000000011111111100000000000000000000000000000000000000000000000000
000000000000000000000000000001000000000000000000000000000001111111101101100100000000000000000000000000000000000000000
000000100000000000000000000000000000000000000000000000000000111111111000100100000000000000000000000000000000000000000
000000000000000000000000010001000000000000000000000000000000011111100000000000000000000000000000000000000000000000000
000000000000000000000010011001000000000000000000000000000000001111111000000000000000000000000000000000000000100000000
000001110110010000000010000000000000000000000000000000000000000010111100000000000000000000000000000000000000100000000
000011100000000000000000000001000000000000000000000000000000000110111111100000000000000000000000000001001100100000000
000111100000000000000000000000000000000000000000000000000000000100011111110000000000000000000000000000000000000000000
000111000000000000000000000000000000000000000000000000000000000000001111111000000000000000000000000010001000000000000
000000000000000000000000000000000000000000000000000000000001000100001111111100000000000000000000010001001000000000000
000000100000000000000000000000000000000000000000000000000000100110001111111110000000000000000000000000000000000000000
000000000000000000000000000000000000000000000000000000000000000000000111111111000000000000000000000000000000000000000
000000000000000000000000000000000000000000000000000000000001000000000011111111100000000000000100110000000000000000000
000000000000000000000000000000000000000000000000000000001101110110000001111111110000000000000000010000000000000000000
000000000000000000000000000000000000000000000000000000001000100000000000111111111000000000000000000000000000000000000
000000000000000000000000000000000000000000000000000000001000000000000000011111111001001001100100000000000000000000000
000000000000000000000000000000000000000010000000000011011001100000000000001111111000000000100110010000000000000000000
000000000000000000000000000000000000000000000000000001101100100000000000000111111100000000000000000000000000000000000
000000000000000000000000000000000000000000000000000001000000000000000000000011111111001000000000000000000000000000000
000000000000000000000000000000000000000000000000010001000000000000000000000000011111001000000000000000000000000000000
000000000000000000000000000000000000000000000000000000000000000000000000000000001111001000000000000000000000000000000
000000000000000000000000000000000000000000000000000000000000000000000000000001001111111001000000000000000000000000000
000000000000000000000000000000000000000000000000000000000000000000000000000000000001111000000000000000000000000000000
000000000000000000000000000000000000000000000000000000000000000000000000000000000001111111000000000000000000000000000
000000000000000000000000000000000000000000000000000000000000000000000000000001001111111111100000000000000000000000000
000000000000000000000000000000000000000000000000000000000000000000000000000000000000011111100000000000000000000000000
000000000000000000000000000000000000000000000000000000000000000000000000000000000000011111110000000000000000000000000
000000000000000000000000000000000000000000000000000000000000000000000000000001000001011111111100000000000000000000000
000000000000000000000000000000000000000000001000000010000000000000000000000001100000001111111110000000000000000000000
000000000000000000000000000000000000000000001000000000000000000000000000000000000000000011111111000000000000000000000
000000000000000000000000000000000000000000000000000000000000000000000000000000000000000001111111100000000000000000000
000000000000000000000000000000000000000000000000000000000000000000000000001001100000000001111111110000000000000000000
000000000000000000000000000000000000010011001000000010000000000000000000000000100000000000111111111000000000000000000
000000000000000000000000000000000000000000000000000000000000000000000000000000000000000000011111111100000000000000000
000000000000000000000000000000000000000000000000000000000000000000000000001000000000000000001111111110000000000000000
000000000000000000000000000000000000010010000000000000000001000000000001001100100000000000000111111111000000000000000
000000000000000000000000000000000000010011000000000000000000000000000000000000000000000000000011111111000000000000000
000000000000000000000000000000000000000000000000000000000000000000000000000000000000000000000001111110000000000000000
000000000000000000000000000000000000000000000000000000000000000000000010000000000000000000000000111111111000000000000
000000000000000000000000000000000100010000000000000000000000000000001001000000000000000000000000011011111100000000000
000000000000000000000000000000100100000000000000000000000000000000000000000000000000000000000000000011111110000000000
000000000000000000000000000000000000000000000000000000000000000000000000000000000000000000000000000011111111000000000
000011000000000000000000000000000000000000000000000000000000000000001011000000000000000000000000000011111111100000000
000000000000000000000000001001100100000000000000000000000000000000001000000000000000000000000000000001111111110000000
000000000000000000000000000000000000000000000000000000000000000000000000000000000000000000000000000000111111111000000
010011000000000000000000000000000000000000000000000000000000000000000000000000000000000000000000000000011111111100000
000011000010000000000000001000000000000000000000000000000000000000111000000000000000000000000000000000001111111110000
000000000000000000000001001000000000000000000000000000000000000000000000000000000000000000000000000000000111111111000
000000000000000000000000000000000000000000000000000000000000000000000000000000000000000000000000000000000011111111100
010001000010000000000000000000000000000000000000000000000000000000000000000000000000000000000000000000000001111111110
000000000010001000010011001000000000000000000000000000000000000000000000000000000000000000000000000000000000111111111
000000000000000000000000000000000000000000000000000000000000000000000000000000000000000000000000000000000000011111111
000000000000000000000000000000000000000000000000000000000000000000000000000000000000000000000000000000000000001111111
000000000011001000010000000000000000000000000000000000000000000000000000000000000000000000000000000000000000000111111
000000000000001000010000000000000000000000000000000000000000000000000000000000000000000000000000000000000000000011111