129 sites
110111000000000000000000000000000000000000000000000000000000000000000000000000000000000000000000000000000000000000000000000000000
111100000000000000000010010000000000000000000000000000000000000000000000000000000000000000000000000000000000000000000000000000000
011100000000000000000110111111000000000000000000000000000000000000000000000000000000000000000000001000000000000000000000000000000
111111000000000000000000000011110000000000000000000000000000000000000000000000000000000000000000000000000000000000000000000000000
100111100000000010010000000011110000000000000000000000000000000000000000000000000000000000000000000000000000000000000000000000000
100111110000000000000000000000110100000000000000000000000000000000000000000000000000000000000000000000000000000000000000000000000
000011111000001110010000000000111100000000000001000000000000000000000000000000000000000000000000000000000000000000000000000000000
000001111100001110000000000000001111000000000000000000000000000000000000000000000000000000000000000000000000000000000000000000000
000000111100011100000000000000001111100000000100000000000000000000000000000000000000000000000000000000000000000100000000100000000
000000011111010000000000000000000011100000000000000000000000000000000000000000000000000000000000000000000000000000000000000000000
000000000111000000000000000000000000111000010000000000000000000000000000000000000000000010000000000000000000000000000000000000000
000000000111110000000000000000000000100000000000000000000000000000000000000000000000000000000000000000000000000000000000000000000
000000000001110000000000000000000000000000000000000000000000000000000000000000000000000000000000000000000000000100001001100000000
000000001101111100000000000000000000000000000000000000000000000000000000000000000000000000000000000000000000000000000001100000000
000000111000011111000000000000000000000000000000000000000000000000000000000000000000000000000000000000000000010100000000111000000
000000111000011110000000000000000000000000000000000000000000000000000000000000000000000000000000000000000000000000000000000000000
000010110000001111110000000000000000000000000000000000000000000000000000000000000000000000000000000000000000000000000000001000000
000000000000001011100000000000000000000000000000000000000000000000000000000000000000000000000000000000000000000000000000001100000
000000000000000011111000000000000000000000000000000000000000000000000000000000000000000000000000000000000000000000000000001111000
000010100000000010111100000000100000000000000000000000000000000000000000000000000000000000000000000000000000010000000000001111000
000000000000000000111110000000000000000000000000000000000000000000000000000000000000000000000000000000000000000000000000000011110
001000000000000000011111010010000000000000000000000000000000000000000000000000000000000000000000001001000000000000000000000011110
011000000000000000001111110000000000000000000000000000000000000000000000000000000000000000000000000000000000000000000000000000011
000000000000000000000111110000000000000000000000000000000000000000000000000000000000000000000000000000010000000000000000000000111
001000000000000000000011110000000000000000000000000000000000000000000000000000000000000000000000000000000000000000000000000000001
011000000000000000000111111110000000000000000000000000000000000000000000000000000000000000000000001000000000000000000000000000000
001000000000000000000000011100000000000000000000000000000000000000000000000000000000000000000000011100000000000000000000000000000
001000000000000000000000011111000000000000000000000000000000000000000000000000000000000000000001111000000000000000000000000000000
001110000000000000000100010111100000000000000000000000000000000000000000000000000000000000000001101000000000000000000000000000000
001110000000000000000000000111110000000000000000000000000000000000000000000000000000000000000111100000000000000000000000000000000
000111100000000000010000000011111000000000000001010000000000000000000000000000000101000000000111100000000000000000000000000000000
000111100000000000000000000001111100000000000000000000000000000000000000000000000000000000011100000000000000000000000000000000000
000000111000000000000000000000111110000000000111000000000000000000000000000000000001001000011110000000000000000000000000000000000
000001111000000000000000000000011111000000000000000000000000000000000000000000000000000000110000000000000000000000000000000000000
000000011100000000000000000000001111100000001100000000000000000000000000000000000000001111110000000000000000000000000000000000000
000000011100000000000000000000000111100000000000000000000000000000000000000000000000000011000000000000000000000000000000000000000
000000001111000000000000000000000011111000010000000000000000000000000000000000000000000010000000000000000000000000000000000000000
000000000010000000000000000000000000111000000000000000000000000000000000000000000000000011000000000000000000000000000000000000000
000000000010000000000000000000000000111110110000000000000000000000000000000000000000000110000000000000000000000000000000000000000
000000000000000000000000000000000000001111111000000000000000000000000000000000000000000110000000000000000000000000000000000000000
000000000000000000000000000000000000001111111000000000000000000000010000000000000000011110100000000000000000000000000000000000000
000000000000000000000000000000000000000111101000000000000000000000010000000000000000000100000000000000000000000000000000000000000
000000000000000000000000000000000000001111111000000000000000000000000000000000000000000100000000000000000000000000000000000000000
000000000010000000000000000000000000101110111100000000000000000000000000000000000000000110000000000000000000000001000000000000000
000000000000000000000000000000000010000111111110000000000000000000010000000000000000011100000000000000000000000001000000000000000
000000001000000000000000000000001010000000011111000000000000000000000000000000000000011000000000000000000000000101001000100000000
000000000000000000000000000000001000000000001111100000000000000000000011100000000011111000001000000000000000000111000000000000000
000000100000000000000000000000101000000000000111110000000000000000000000000000000011000000000010000000000000011100000000000000000
000000000000000000000000000000000000000000000011111000000011001000000000100000010111000000000000000000000000011110000000000000000
000000000000000000000000000000100000000000000001111000000000000000000000000000011110000000000000100000000001110000000000000010000
000000000000000000000000000000000000000000000000111110110010000000000000000000111000000000000000000000000001111000000000000000000
000000000000000000000000000000000000000000000000001111110000000000000000000000101000000000000000000000000101100000000000000000000
000000000000000000000000000000000000000000000000001111110000000000000000000000000000000000000000000000000011100000000000000100000
000000000000000000000000000000000000000000000000000111110000000000000000000000000000000000000000000000000000000000000000000000000
000000000000000000000000000000000000000000000000001111111110000000000000000000100000000000000000000000000000100000000000000000000
000000000000000000000000000000000000000000000000001111111111000000000000000000000000000000000000000000000000101000000100010000000
000000000000000000000000000000000000000000000000000000111111100000000000000000000000000000000000000000000000000000000100000000000
000000000000000000000000000000000000000000000000000000111111110000000000000000100000000000000000000000000000000000000000000000000
000000000000000000000000000000000000000000000000101000111111111000000000110010110000000000000000000000000000000010000000000000000
000000000000000000000000000000000000000000000000100000011111111100000000000000000000000000000000000000000000001010000110000000000
000000000000000000000000000000000000000000000000000000001111111110000000000000000000000000000000000000000000000000000000000000000
000000000000000000000000000000000000000000000000000000000111111111000000010010000000000000000000000000000000000000000000000000000
000000000000000000000000000000000000000000000000100000000011111111000101110010000000000000000000000000000000000010000100000000000
000000000000000000000000000000000000000000000000000000000001111111000001000000000000000000000000000000000000000010100100000000000
000000000000000000000000000000000000000000000000000000000000111111100000010000000000000000000000000000000000000000000000000000000
000000000000000000000000000000000000000000000000000000000000011111101111111000000000000000000000000000000000000000000000000000000
000000000000000000000000000000000000000000000000000000000000000011111101000000000000000000000000000000000000000000000000000000000
000000000000000000000000000000000000000011001000000000000000000000111111000000000000010000000000000000000000000000000000000000000
000000000000000000000000000000000000000000000000000000000000000001111110000000000000000000000000000000000000000000000000000000000
000000000000000000000000000000000000000000000000000000000000001001111111111000000000000000000000000000000000000000000000000000000
000000000000000000000000000000000000000000000010000000000000000001011111100000000011110000000000000000000000000010000000000000000
000000000000000000000000000000000000000000000010000000000000001101110111100000000000010000000000000000000000000011100000000000000
000000000000000000000000000000000000000000000010100000000010001001000111111010010010000000000000000000000000000010000000000000000
000000000000000000000000000000000000000000000000000000000010011011000100111110010000000000000000000000000000000000000000000000000
000000000000000000000000000000000000000000000000000000000000000001000100111110000000000000000000000000000000000000000000000000000
000000000000000000000000000000000000000000000000000000000000000000000000011111000000000000000000000000000000000000000000000000000
000000000000000000000000000000000000000000000000000000000010011000000000111111110000000000000000000000000000000000000000000000000
000000000000000000000000000000000000000000000000000000000000000000000000000111110000000000000000000000000000000000000000000000000
000000000000000000000000000000000000000000000000001100100110000000000000000011110000000000000000000000000000000000000000000000000
000000000000000000000000000000000000000000000000111000000010000000000000110011111110000000000000000000000000000000000000000000000
000000000000000000000000000000000000000000000000011100000000000000000000000000011100000000000000100011000001000000000000000000000
000000000000000000000000000000100000000000000000110000000000000000000000000000011110000000000011100010000000000000000000000000000
000000000000000000000000000000000000000000000011110000000000000000000010100000010111000000000010000000000000000010000000000000000
000000000000000000000000000000101000000000000011100000000000000000000010000000000011111000001110000000000000000000000000000000000
000000000000000000000000000000000000000000000010000000000000000000000010000000000001111000001000000000000000000000000000000000000
000000000000000000000000000000000000000010001110000000000000000000010011000000000001111100000000000000000000000001000000000000000
000000000000000000000000000000001010000010001110000000000000000000000000000000000001111100111000000000000000000000000000000000000
000000000000000000000000000000000010001111111000000000000000000000000000000000000000011111100000000000000000000000000000000000000
000000000010000000000000000000000011111110010000000000000000000000000000000000000000000111100000000000000000000000000000000000000
000000000000000000000000000000000011010000000000000000000000000000000000000000000000000111100000000000000000000000000000000000000
000000000000000000000000000000000110000010000000000000000000000000000000000000000000001111111000000000000000000000000000000000000
000000000000000000000000000000011110000000000000000000000000000000000000000000000000001000111100000000000000000000000000000000000
000000000000000000000000000000011000000000000010000000000000000000000000000000000001101000111110000000000000000000000000000000000
000000000000000000000000000001111000000000000000000000000000000000000000000000000001000000011111000000000000000000000000000000000
000000000000000000000000000001101000000000000001000000000000000000000000000000000111000000001111100000000000000000000000000000000
000000000000000000000000000111100000000000000000000000000000000000000000000000000100000000000111100000000000000000000000000000000
000000000000000000000000000111100000000000000000010000000000000000000000000000001100000000000011111010000000000000000000000000000
000000000000000000000000001100000000000000000000000000000000000000000000000000000000000000000000111110000000000000000000000000000
001000000000000000000100011110000000000000000000000000000000000000000000000000000000000000000000111111000000000000000000000000100
000000000000000000000000001000000000000000000000000000000000000000000000000000000000000000000000011111000000000000000000000000000
000000000000000000000000000000000000000000000000000000000000000000000000000000001100000000000000111111000000000000000000000000000
000000000000000000000100000000000000000000000000000000000000000000000000000000001000000000000000001111110101000000000000000010100
000000000000000000000000000000000000000000000000000000000000000000000000000000000000000000000000000001111100000000000000000000100
000000000000000000000001000000000000000000000000000000000000000000000000000000000000000000000000000001111100000000000000000000110
000000000000000000000000000000000000000000000000000000000000000000000000000000000000000000000000000000111100000000000000000001110
000000000000000000000000000000000000000000000000000100000000000000000000000000000000000000000000000001111111000000000000000001100
000000000000000000000000000000000000000000000000000010000000000000000000000000000000000000000000000000000111100000000000000111000
000000000000000000000000000000000000000000000000011110000000000000000000000000001000000000000000000001000111110000000000000111000
000000000000000000000000000000000000000000000000011110110000000000000000000000000000000000000000000000000011111000000000011110000
000000000000001000010000000000000000000000000001111000000000000000000000000000000000000000000000000000000001111000000000011110000
000000000000000000000000000000000000000000000001101000010001000000000000000000000000000000000000000000000000111110001100111000000
000000001000101000000000000000000000000000000111100000000000000000000000000000000000000000000000000000000000001111001100110000000
000000000000000000000000000000000000000000000010100000000011001100000011100000000010000000000000000000000000001111001100000000000
000000000000000000000000000000000000000000011110000000000000000000000001000000000000010000000000000000000000000111111000100000000
000000000000000000000000000000000000000000000000000000000000000100000001000000000000000000000000000000000000000001111000000000000
000000000000000000000000000000000000000000000000000000000000000000000000000000000000000000000000000000000000000001111100000000000
000000000000100000000000000000000000000000000100000000000000000000000000000000000000000000000000000000000000001111111111100000000
000000000000000000000000000000000000000000000000000000011001001100000000000000000000000000000000000000000000001110011111110000000
000000000000000000000000000000000000000000000000000000000001000000000000000000000000000000000000000000000000000000001111010000000
000000000000110000000000000000000000000000000000000000000000000000000000000000000000000000000000000000000000000000001111110000000
000000001000111000000000000000000000000000000100000000000000000000000000000000000000000000000000000000000000001101001101110000000
000000000000001000000000000000000000000000000000000000010000000000000000000000000000000000000000000000000000111100000111111000000
000000000000001011110000000000000000000000000000000000000000000000000000000000000000000000000000000000000000111000000000011110000
000000000000000001110000000000000000000000000000000010000000000000000000000000000000000000000000000000000011110000000000001111000
000000000000000000111100000000000000000000000000010000000000000000000000000000000000000000000000000001000011110000000000001111000
000000000000000000111100000000000000000000000000000000000000000000000000000000000000000000000000000000001111000000000000000111110
000000000000000000001101000000000000000000000000000000000000000000000000000000000000000000000000001001111100000000000000000001110
000000000000000000001111000000000000000000000000000000000000000000000000000000000000000000000000000000011000000000000000000001111
000000000000000000000011100000000000000000000000000000000000000000000000000000000000000000000000000000000000000000000000000000011