101 sites
11100000000000000000000000000000000000000000000000000000000000000000000000000000000000000000000000000
11111000000000000000000000000000000000000000000000000000000000000000000000000000000000000000000000000
11111000000000000000000000000000000000000000000000000000000000000000000000000000000000000000000000000
01111100000000000000000000000000000000000000000000000000000000000000000000000000000000000000000000000
01111110000000000000000000000000000000000000000000000000000000000000000000000000000000000000000000000
00011111000000000000000000000000000000000000000000000000000000000000000000000000000000000000000000000
00001111100000000000000000000000000000000000000000000000000000000000000000000000000000000000000000000
00000111110000000000000000000000000000000000000000000000000000000000000000000000000000000000000000000
00000011111000000000000000000000000000000000000000000000000000000000000000000000000000000000000000000
00000001111000000000000000000000000000000000000000000000000000000000000000000000000000000000000000000
00000000111110000000000000000000000000000000000000000000000000000000000000000000000000000000000000000
00000000001111000000000000000000000000000000000000000000000000000000000000000000000000000000000000000
00000000001111100000000000000000000000000000000000000000000000000000000000000000000000000000000000000
00000000000111101000000000000000000000000000000000000000000000000000000000000000000000000000000000000
00000000000011111000000000000000000000000000000000000000000001011000000000000000000000000000000000000
00000000000000111010000000000000000000000000000000000000000001000000000000000000010000000000000000000
00000000000001111110000000000000000000000000000000000000000000000000000000000000000000000000000000000
00000000000000001110000000000000000000000000000000000000000000000000000000000000000000000000000000000
00000000000000011111100000000000000000000000000000000000000000000000000000000000011010000000000000000
00000000000000000011110000000000000000000000000000000000000000000000000000000000011000000000000000000
00000000000000000011111000000000000000000000000000000000000001000000000000000001111000000000000000000
00000000000000000001111100000000000000000000000000000011001000000000000000000001100000000000000000000
00000000000000000000111110000000000000000000000000000000000000000000000000000111100000000000000000000
00000000000000000000011111000000000000000100000000110011000000000000000000000110100000000000000000000
00000000000000000000001111100000000000000000000000100000000000000000000000011100000000000000000000000
00000000000000000000000111110000000000000000000011100000000000000000001000011110000000000000000000000
00000000000000000000000011111000000000000000000011100000000000000000001001110000000000000000000000000
00000000000000000000000001111100110000000000000111000000000000000000001111110000000000000000000000000
00000000000000000000000000111100000000000000000111000000000000000000000001000000000000000000000000000
00000000000000000000000000011111010000000000010110000000000000000000000010000000000000000000000000000
00000000000000000000000000000111000000000000000000000000000000000000000010000000000000000000000000000
00000000000000000000000000000111110000000000000100000000000000000000000010000000000000000000000000000
00000000000000000000000000010001111000000000000000000000000000000000011110000000000000000000000000000
00000000000000000000000000010101111100000000110110000000000000000000011000000000000000000000000000000
00000000000000000000000000000000111110000000000000000000000000000001111000000000000000000000000000000
00000000000000000000000000000000011110010100110010000000000010000001101000000000000000000000000000000
00000000000000000000000000000000001111110000000000000000000010000111000000000000000000000000000000000
00000000000000000000000000000000000011110000000000000000000110111111000000000000000000000000000000000
00000000000000000000000000000000000011110000000000000000000100001000000000000000000000000000000000000
00000000000000000000000000000000000111111101100000000000000110000000000000000000000000000000100000000
00000000000000000000000000000000000000011111100000000000011100000000000000000000000100000100100010000
00000000000000000000000100000000000100011111100000000001001110000000000000000010100000000000000000000
00000000000000000000000000000000000000001111100000001101111000000000000000000000000000000000000100000
00000000000000000000000000000000000000011111100000000000000000000000000000000000000000000100110110000
00000000000000000000000000000000010100011111111010000000000000000000000000000000000000000000000000000
00000000000000000000000000000100010100000000111110000000000000000000000000000000000000000000000000000
00000000000000000000000000000000000000000000111110000000000000000000000000000000000000000000000000000
00000000000000000000000000011101010000000000011111000000000000000000000000000000000000000000000000000
00000000000000000000000001111100010100000000111111100000000000000000001000000000000000000000000000000
00000000000000000000000001111000000000000000000111100000000000000000000000000000000000000000000000000
00000000000000000000000111100000000000000000000011111011000000000000000000000000000000000000000000000
00000000000000000000000100000000000000000000000000111111000000000000000000000000000000000000000000000
00000000000000000000000000000000000000000010000000111111100000000000000000000000000000000000000000000
00000000000000000000000000000000000000000010000000011111100000000000000000000000000000000000000000000
00000000000000000000010100000000000000000000000000111111101000000000000000000000100000000000000000000
00000000000000000000010100000000000000000110000000111111111000000000000000000000100000000000000000000
00000000000000000000000000000000000000000010000000001111111000000000000000000000000000000000000000001
00000000000000000000000000000000000000001010000000000001111000000000000000000000001100010100000000001
00000000000000000000010000000000000000001110000000000011111100000000000000000000111100000000000000000
00000000000000000000000000000000000001111100000000000000001111000000000000000000110100000000000000000
00000000000000000000000000000000000111010100000000000000000111100001100000000011110000000000000000000
00000000000000110000100000000000000000000000000000000000000111100000000000000001110000000000000000000
00000000000000000000000000000000000001000000000000000000000011110011100000000000000000000000000000000
00000000000000100000000000000000000001000000000000000000000000111110000000000000000000000000000000000
00000000000000100000000000000000000001100000000000000000000000011110000000000000000000000000000000000
00000000000000000000000000000000000011000000000000000000000000011110000000000000000000000000000000000
00000000000000000000000000000000000011000000000000000000000000111111100000000000000000000000000000000
00000000000000000000000000000000001111000000000000000000000010100011110000000000000000000000000000000
00000000000000000000000000000000001100000000000000000000000010100011111000001010000000000000000000000
00000000000000000000000000000000111000000000000000000000000000000001111100000000000000000000000000000
00000000000000000000000001110000111100000000000010000000000000000000111100101000000000000000000000000
00000000000000000000000000010000100000000000000000000000000000000000011111100000000000000000000000000
00000000000000000000000000010111100000000000000000000000000000000000000111100000000000000000000000000
00000000000000000000000000111000000000000000000000000000000000000000000111110000000000000000000000000
00000000000000000000000000110000000000000000000000000000000000000000001111111000000000000000000000000
00000000000000000000000011110000000000000000000000000000000000000000000001111000000000000000000000000
00000000000000000000000011000000000000000000000000000000000000000000101000111110000000000000000000000
00000000000000000000001111000000000000000000000000000000000000000000000000001111000000000000000000000
00000000000000000000001101000000000000000100000000000000000010000000100000001111100000000000000000000
00000000000000000000111000000000000000000000000000000000000011000000000000000111110000000000000000000
00000000000000000000111100000000000000000100000000000011001111000000000000000011111000000000000000000
00000000000000010011100000000000000000000000000000000000001111000000000000000001111000000000000000000
00000000000000000011100000000000000000000000000000000000011000000000000000000000111110010000000000000
00000000000000000000000000000000000000001000000000000000011100000000000000000000001111010100000000000
00000000000000000010000000000000000000000000000000000000000000000000000000000000001111010000000000000
00000000000000000000000000000000000000000000000000000000000000000000000000000000000111111000000000000
00000000000000000000000000000000000000000000000000000000000000000000000000000000000001111000000000010
00000000000000000000000000000000000000000000000000000000010000000000000000000000001111111100000000011
00000000000000000000000000000000000000000000000000000000000000000000000000000000000001111110000010111
00000000000000000000000000000000000000001001000000000000010000000000000000000000000100011111100011111
00000000000000000000000000000000000000000000000000000000000000000000000000000000000000001111100011100
00000000000000000000000000000000000000000000000000000000000000000000000000000000000000000111101000000
00000000000000000000000000000000000000011001000000000000000000000000000000000000000000000111111110000
00000000000000000000000000000000000000000001000000000000000000000000000000000000000000000000111100000
00000000000000000000000000000000000000000000000000000000000000000000000000000000000000000001111111000
00000000000000000000000000000000000000000011000000000000000000000000000000000000000000000000111111000
00000000000000000000000000000000000000001001000000000000000000000000000000000000000000001110101111101
00000000000000000000000000000000000000000000000000000000000000000000000000000000000000000110001111100
00000000000000000000000000000000000000000000000000000000000000000000000000000000000000001110000011111
00000000000000000000000000000000000000000000000000000000000000000000000000000000000000111100000000111
00000000000000000000000000000000000000000000000000000000110000000000000000000000000000011100000010111