125 sites
11001100000000000000000000000000000001100100001111000000000000000000000000000000000000000000000000000000000000000000000000000
11111100000000000000000000000000000000000000000011110000000000000000000000000000000000000000000000000000000000000000000000000
01111110000000000000000000000000001000100000000011110000000000000000000000001010000000000000000000001000000000100000000000000
01111111000000000000000000000000000000000000000000111000000000000010000000000000000000000000000000000000000000000000000000000
11111111100000000000000000000000000000000000000000000000000000000000000000000000000000000000000000000000000000000000000000000
11111111100001001000000000000000001001100000000000000000000000000000000000000000000000000000000000000000000000000000000000000
00111111100000000000000000000010001000000000000000000000000000000010000000001000000000000000000000000000000000000000000000000
00011111100000000000000000000000000000000000000000000000000000000000000000000000000000000000000000000000000000000000000000000
00001111111011001000000000000000000000000000000000000000000000000000000000000000000000000000000000000000000000000000000000000
00000000111111000000000000000000000000000000000000000000000000000000000000000000000000000000000000000000000000000000000000000
00000000111111100000000000000010010000000000000000000000000000000000000000000000000000000000000000000000000000000000000000000
00000000011111110000000000000000000000000000000000000000000000000000000000000000000000000000000000000000000000000000000000000
00000000111111111000000000000000000000000000000000000000000000000000000000000000000000000000000000000000000000000000000000000
00000100111111111100000001000010011001000000000000000000000000000000000000000000000000000000000000000000000000000000000000000
00000000001111111110000001100000010000000000000000000000000000000000000000000000000000000000000000000000000000000000000000000
00000000000111111111000000000000000000000000000000000000000000000000000000000000000000000000000000000000000000000000000000000
00000100100011111111100000000000000001000000000000000000000000000000000000000000000000000000000000000000000000000000000000000
00000000000001111111101001000000010011001000000000000000000000000000000000000000000000000000000000000000000000000000000000000
00000000000000111111101101000000000000000000000000000000000000000000000000000000000000000000000000000000000000000000000000000
00000000000000011111100000000000000000000000000000000000000000000000000000000000000000000000000000000000000000000000000000000
00000000000000001111111000000000000001001100100000000000000000000000000000000000000000000000000000000000000000000000000000000
00000000000000000000111100000000000000001000000000000000000000000000000000000000000000000000000000000000000000000000000000000
00000000000000000110111111000000000011001000000000000000000000000000000000000000000000000000000000000000000000000000000000000
00000000000000000010011111000000000000000000000000000000000000000000000000000000000000000000000000000000000000000000000000000
00000000000000000000001111111000000000000000000000000000000000000000000000000000000000000000000000000000000000000000000000000
00000000000001100110001111111000010010000000000000000000000000000000000000000000000000000000000000000000000000000000000000000
00000000000000100000000011111000000000000000000000000000000000000000000000000000000000000000000000000000000000000000000000000
00000000000000000000000011111000000000000000000000000000000000000000000000000000000000000000000000000000000000000000000000000
00000000000000000000000011111110110010000000000000000000000000000000000000000000000000000000000000000000000000000000000000000
00000000000000000000000000001111110000000000000000000000000000000000000000000000000000000000000000000000000000000000000000000
00000010001001000000000000001111111000000000000000000000000000000000000000000000000000000000000000000000000000000000000000000
00000000000000000000000000000111111100000000000000000000000000000000000000011000000000000000000000000000000000000000000000000
00000000000000000000000000001111111110000000000000000000000000000000000000000000000000000000000000000000000000000000000000000
00000000001001100100000001001111111111000000000000000000000000000000000000000000000000000000000000000000000000000000000000000
00100110000001000000000000000011111111100000000000000000000000000000000000001000000000000000000000000000000000000000000000000
00000000000000000000000000000001111111110000000000000000000000000000000000001000000000000000000000000010000000100000000000000
00000000000000000100001001001000111111111000000000000000000000000000000000000000000000000000000000000000000000000000000000000
10000100000001001100101000000000011111111100000000000000000000000000000000000000000000000000000000000000000000000000000000000
10100100000000000000000000000000001111111110000010000000000000000000000000000000000000000000000000001010000000100000000000000
00000000000000000000000000000000000111111111000000000000000000000000000000000000000000000000000000000011000000000000000000000
00000000000000000100111000000000000011111111100000000000000000000000000000000000000000000000000000000000000000000000000000000
10000000000000000000100000000000000001111111101010000000000000000000000000000000000000000000000000000000000000000000000000000
00000000000000000000000000000000000000111111111110000000000000000000000000000000000000000000000000000110000000000000000000000
00000000000000000000000000000000000000011111110000000000000000000000000000000000000000000000000000000010000000000000000000000
00000000000000000000100000000000000000001111111000000000000000000000000000000000000000000000000000000000000000000000000000000
00000000000000000000000000000000000000000011111000000000000000000000000000000000000000000000000000000000000000000000000000000
10000000000000000000000000000000000000000110111110000000000000000000000000000000000000000000000000000000000000000000000000000
10000000000000000000000000000000000000000010001111000000000000000000000000000000000000000000000000010000000000000000000000000
11100000000000000000000000000000000000100110001111100000000000000000000000000000000000000000000000011110000000000000000000000
11100000000000000000000000000000000000000000000111110000000000000000000000000000000000000000000001111000000000000000100000000
01110000000000000000000000000000000000000000000011111000000000001000000000000010000000000000000001101000000000101000000000000
01110000000000000000000000000000000000000000000001111000000000001000000000000010000000000000000111100000000000000000000000000
00010000000000000000000000000000000000000000000000111110000000011111010000000110000000000000000110000000000000000000000000000
00000000000000000000000000000000000000000000000000001111000000001111010100000000000000000000011110000000000000000000000000000
00000000000000000000000000000000000000000000000000001111100000111100000000000000100001000011111110000000000000000000000000000
00000000000000000000000000000000000000000000000000000111110000110100000100000000000000000000110000000000000000000000000000000
00000000000000000000000000000000000000000000000000000011110011100000000000000000100001000011100000000000000000000000000000000
00000000000000000000000000000000000000000000000000000001111111110000000000000000000000000000000000000000000000000000000000000
00000000000000000000000000000000000000000000000000000000011110000000000000000000000000000000000000000000000000000000000000000
00000000000000000000000000000000000000000000000000000000011111000000000000000000001000000000000000000000000000000000000000000
00000000000000000000000000000000000000000000000000000000111111000000000000000000001001000000000000000000000000000000000000000
00000000000000000000000000000000000000000000000000000000110111110000000000000001111001000000000000000000000000000000000000000
00000000000000000000000000000000000000000000000000000011110001111000000000000000100001000010100000000000000000000000000000000
00000000000000000000000000000000000000000000000000001011010001111100000001000111100000000000000000000000000001000000000000000
00000000000000000000000000000000000000000000000000111110000000111100000000000110100000000000000010000000000000001000000000000
00000000000000000000000000000000000000000000000000001111000000011111010111100100000000000000000000000000000000000000000000000
00010010000000000000000000000000000000000000000000001100000000000111110000101000000000000000000000000000000000000000000000000
00000000000000000000000000000000000000000000000000001100000000000111110000000000000000000000000100000000000000000000000000000
00000000000000000000000000000000000000000000000000000000000000000011111000000000000000000000000000000000000000000000000000000
00000000000000000000000000000000000000000000000000001100000000000111111111100000000000000000000000000000000000000000000000000
00000000000000000000000000000000000000000000000000000000000000000000111110000000000000000000000000000000000000000000000000000
00000000000000000000000000000000000000000000000000000101000000000100011111000000000000000000000000000000000000000000000000000
00000000000000000000000000000000000000000000000000000000000000000100011111100000000000000000000000000000000000000000000000000
00000000000000000000000000000000000000000000000000000000000000010100010111100100000000000000000000000000000000000000000000000
00000000000000000000000000000000000000000000000000000000000000000110010011111100000000000000000000000000000000000000000000000
00000000000000000000000000000001000000000000000000000000000000000000000000111100000000000000000000000000000011000000000000000
00100010000000000000000000000001001100000000000000000000000000000010000000111110000000000000000000000000000001100000000000000
00000000000000000000000000000000000000000000000000001000000000011100000001111111000000000000000000000000000001100000000000000
00100000000000000000000000000000000000000000000000111000000000011000000000001111100000000000000000001000000001111000000000000
00000000000000000000000000000000000000000000000000000000000001010000000000000111110000000000000000000000000001111000000000000
00000000000000000000000000000000000000000000000000000010100001111000000000000011110011000010000010000000000000011000000000000
00000000000000000000000000000000000000000000000000000000000001000000000000000001111111000000000000000000000000011000000000000
00000000000000000000000000000000000000000000000000000000000111000000000000000000011111100000000000000000000000000000000000000
00000000000000000000000000000000000000000000000000000000000000000000000000000000011111110000000000000000000000000000000000000
00000000000000000000000000000000000000000000000000000000000000000000000000000000111111111010000000000000000000001001000000000
00000000000000000000000000000000000000000000000000000010100011100000000000000000111111111110000000000000000000000000000000000
00000000000000000000000000000000000000000000000000000000000000000000000000000000001111111100000000000000000000000000000000000
00000000000000000000000000000000000000000000000000000000000000000000000000000000000111111100000000000000000000000001000000000
00000000000000000000000000000000000000000000000000000000000000000000000000000000000011111110000000000000000000000001001000010
00000000000000000000000000000000000000000000000000000000000000000000000000000000000001111111000000000000000000000000000000000
00000000000000000000000000000000000000000000000000000010100000100000000000000000100011001111001010000000000000000001001000000
00000000000000000000000000000000000000000000000000000010100000000000000000000000000000000111111000000000000000000000000000000
00000000000000000000000000000000000000000000000000000011100000100000000000000000000000000001111000000000000000000000000000000
00000000000000000000000000000000000000000000000000000111000000000000000000000000000000000001111000000000000000000000000000000
00000000000000000000000000000000000000000000000000000110000000000000000000000000000000000011111110000000000000000000001100000
00000000000000000000000000000000000000000000000000011110000000000001000000000000000000000000001111000000000000000000011110000
00000000000000000000000000000000000000000000000000011110000000001000000000000000100000000010001111100000000000001001011000000
00000000000000000000000000000000000000000000000001110000000000000000000000000000000000000000000111100000000000000001110000000
00000000000000000000000000000000000000000000000001110000000000000000000000000000000000000000000011111000000000001111110000000
00000000000000000000000000000000000000000000000111000000000000000000000000000000000000000000000000111100000000001110100000000
00100000000000000000000000000000000000100000000011100000000000000000000000000010000000000000000000111110000000111100000000000
00000000000000000000000000000000000000000010000010000000000000000000000000000000000000000000000000011110000000110100000000000
00000000000000000000000000000000000100110011000010000000000000000000000000000000000000000000000000001111100000100000000000000
00000000000000000000000000000000000000010000000000000000000000000000000000000000000000000000000000000011100111110000000000000
00000000000000000000000000000000000000000000000000000000000000000000000000000000000000000000000000000011111100000000000000000
00000000000000000000000000000000000000000000000000000000000000000000000000000000000000000000000000000000111100000000000000000
00000000000000000000000000000000000000000000000000000000000000000000000000000000000000000000000000000000111100000000000000000
00000000000000000000000000000000000000000000000000000000000000000000000000000000000000000000000000000001111111010000000000000
00000000000000000000000000000000000000000000000000000000000000000000000000010000000000000000000000000001000111000000000000000
00000000000000000000000000000000000000000000000000000000000000010000000000011111000000000000000000000001000111110000000000000
00100000000000000000000000000000000100100000000000100000000000000000000000001111000000000000000000001111000001111000000000000
00000000000000000000000000000000000000000000000000000000000000000000000000000011110000000000000000001101000101111100000000000
00000000000000000000000000000000000000000000000000100000000000001000000000000011110010000000000010111000000000111111000000000
00000000000000000000000000000000000000000000000000000000000000000000000000000000000000000000000000111100000000011110000000000
00000000000000000000000000000000000000000000000000000000000000000000000000000000000000000000000000110000000000001111100000000
00000000000000000000000000000000000000000000000000000000000000000000000000000000000010011010000011100000000000001011111000010
00000000000000000000000000000000000000000000000001000000000000000000000000000000000000000000000001110000000000000011110000010
00000000000000000000000000000000000000000000000000000000000000000000000000000000000000000000000111100000000000000001111111110
00000000000000000000000000000000000000000000000000000000000000000000000000000000000000001010001110000000000000000001011111110
00000000000000000000000000000000000000000000000000000000000000000000000000000000000000000000001100000000000000000000011111000
00000000000000000000000000000000000000000000000000000000000000000000000000000000000000000000000100000000000000000000011111000
00000000000000000000000000000000000000000000000000000000000000000000000000000000000000000000000000000000000000000000011111110
00000000000000000000000000000000000000000000000000000000000000000000000000000000000000000000000000000000000000000000011001111
00000000000000000000000000000000000000000000000000000000000000000000000000000000000000001000000000000000000000000001111001111
00000000000000000000000000000000000000000000000000000000000000000000000000000000000000000000000000000000000000000000000000111