94 sites
1100000000000000000000000000000000000000000000000000000000000000000000000000000000000000000000
1111000000000000000000000000000000000000000000000000000000000000000000000000000000000000000000
0111100000101000000000000000000000000000000000000000000000000000000000000000000000000000000000
0111110000000000000000000000000000000000000000000000000000000000000000000000000000000000000000
0011110011100000000000000000000000000000000000000000000000000000000000000000000000000000000000
0001111110000000000000000000000000000000000000000000000000000000000000000000000000000000000000
0000011110000000000000000000000000000000000000000000000000000000000000000000000000000000000000
0000011110000000000000000000000000000000000000000000000000000000000000000000000000000000000000
0000111111100000000000000000000000000000000000000000000000000000000000000000000000000000000000
0000100011110000000000000000000000000000000000000000000000000000000000000000000000000000000000
0010100011111000000000000000000000000000000000000000000000000000000000000000000000000000000000
0000000001111100000000000000000000000000000000000000000000000000000000000000000000000000000000
0010000000111110000000000000100000000000000000000000000000000000000000000000000000000000000000
0000000000011111000000000000000000000000000000000000000000000000000000000000000000000000000000
0000000000001111110000000010000000000000000000000000000000000000000000000000000000000000000000
0000000000000111110000000000000000000000000000000000000000000000000000000000000000000000000000
0000000000000011110000000000000000000000000000000000000000000000000000000000000000000000000000
0000000000000011111100000000000000000000000000000000000000000000000000000000000000000000000000
0000000000000000011110000000000000000000000000000000000000000000000000000000000000000000000000
0000000000000000011110010010000000000000000000000000000000000000000000000000000000000000000000
0000000000000000001111110000000000000000000000000000000000000000000000000000000000000000000000
0000000000000000000011110000000000000000000000000000000000000000000000000000000000000000000000
0000000000000000000011110000000000000000000000000000000000000000000000000000000000000000000000
0000000000000000000111111110000000000000100000000000000000000000000000000000000000000000000000
0000000000000000000000011100000000000001110000000000000000000000000000000000000000000000000000
0000000000000000000000011111000000000111100000000000000000000000000000000000000000000000000000
0000000000000010000100010111100000001110000000000000000000000000000000000000000000000000000000
0000000000000000000000000111110000101110000000000000000000000000000000000000000000000000000000
0000000000001000000000000011111000111100000000000000000000000000000000000000000000000000000000
0000000000000000000000000001111111110000000000000000000000000000000000000000000000000000000000
0000000000000000000000000000111101010000000000000000000000000000000000000000000000000000000000
0000000000000000000000000000011111000000000000000000000000000000000000000000000000000000000000
0000000000000000000000000000010111000000000000000000000000000000000000000000000000000000000000
0000000000000000000000000000011111110000000000000000000000000000000000000000000000000000000000
0000000000000000000000000001110001111100000000000000000000000000000000000000000000000000000000
0000000000000000000000000000111001111000000000000000000000000000000000000000000000000000000000
0000000000000000000000000011100000111110000000000000000000000000000000000000000000000000000000
0000000000000000000000000111100000101111000000000000000000000000000000000000000000000000000000
0000000000000000000000000111000000001111100000000000000000000000000000000000000000000000000000
0000000000000000000000001100000000000111110100000000000000000000000000000000000000000000000000
0000000000000000000000011100000000000011110000000000000000000000000000000000000000000000000000
0000000000000000000000001000000000000001111100000000000000000000000000000000000000000000000000
0000000000000000000000000000000000000000011110000001000000000000000000000000000000000000000000
0000000000000000000000000000000000000001011111000000000000000000000000000000000000000000000000
0000000000000000000000000000000000000000001111110111000000000000000000000000000000000000000000
0000000000000000000000000000000000000000000111101100000000000000000000000000000000000000000000
0000000000000000000000000000000000000000000011111100000000000000000000000000000000000000000000
0000000000000000000000000000000000000000000010111100000000001000000000000000000000000000000000
0000000000000000000000000000000000000000000001111100000000011100000000000000000000000000000000
0000000000000000000000000000000000000000000011111111000001111000000000000000000000000000000000
0000000000000000000000000000000000000000000010000111100001101000000000000000000000000000000000
0000000000000000000000000000000000000000001010000111100111100000000000000000000000000000000000
0000000000000000000000000000000000000000000000000011111111100000000000000000000000000000000000
0000000000000000000000000000000000000000000000000000111100000000000000000000000000000000000000
0000000000000000000000000000000000000000000000000000111110000000000000000000000000000000000000
0000000000000000000000000000000000000000000000000001111110000000000000001010000000000000000000
0000000000000000000000000000000000000000000000000001101111100000000000000000000000000000000000
0000000000000000000000000000000000000000000000000111100011110000000000101000000000000000000000
0000000000000000000000000000000000000000000000000111100011111000000000000000000000000000000000
0000000000000000000000000000000000000000000000001100000001111110001000000000000000000000000000
0000000000000000000000000000000000000000000000011110000000111100000000000000000000000000000000
0000000000000000000000000000000000000000000000001000000000011111000000000000000000000000000000
0000000000000000000000000000000000000000000000000000000000010111001000000000000000000000000100
0000000000000000000000000000000000000000000000000000000000000111111000000000000000000000000100
0000000000000000000000000000000000000000000000000000000000000001111100000000000000000000000101
0000000000000000000000000000000000000000000000000000000000000001111100000000000000000000000000
0000000000000000000000000000000000000000000000000000000000010011111110000000000000000000010100
0000000000000000000000000000000000000000000000000000000000000000111110000000000000000000011100
0000000000000000000000000000000000000000000000000000000000000000001111100000000000000000110000
0000000000000000000000000000000000000000000000000000000000000000000011110000000000000011110000
0000000000000000000000000000000000000000000000000000000001000000000011111000000000000011010000
0000000000000000000000000000000000000000000000000000000000000000000001111100000000001111000000
0000000000000000000000000000000000000000000000000000000101000000000000111110000000011111000000
0000000000000000000000000000000000000000000000000000000000000000000000011111000001011000000000
0000000000000000000000000000000000000000000000000000000100000000000000001111100001111000000000
0000000000000000000000000000000000000000000000000000000000000000000000000111100111100000000000
0000000000000000000000000000000000000000000000000000000000000000000000000011111111100000000000
0000000000000000000000000000000000000000000000000000000000000000000000000000111000000000000000
0000000000000000000000000000000000000000000000000000000000000000000000000000111110000000000000
0000000000000000000000000000000000000000000000000000000000000000000000000001101111000000000000
0000000000000000000000000000000000000000000000000000000000000000000000000001101111100000000000
0000000000000000000000000000000000000000000000000000000000000000000000000111100111111000000000
0000000000000000000000000000000000000000000000000000000000000000000000000011100011110000000000
0000000000000000000000000000000000000000000000000000000000000000000000001110000001111100000000
0000000000000000000000000000000000000000000000000000000000000000000000011110000001011110000000
0000000000000000000000000000000000000000000000000000000000000000000000011000000000011111000000
0000000000000000000000000000000000000000000000000000000000000000000001111000000000001111100000
0000000000000000000000000000000000000000000000000000000000000000000001111000000000000111110000
0000000000000000000000000000000000000000000000000000000000000000000011000000000000000011111000
0000000000000000000000000000000000000000000000000000000000000000001111100000000000000001111100
0000000000000000000000000000000000000000000000000000000000000000000100000000000000000000111110
0000000000000000000000000000000000000000000000000000000000000011101100000000000000000000011111
0000000000000000000000000000000000000000000000000000000000000000000000000000000000000000001111
0000000000000000000000000000000000000000000000000000000000000000100000000000000000000000000111