106 sites
1110000000000000000000000000000001111010100000000000000010000000000000100000000000000000000000000000000000
1111000000000000000000000000000001000010101011000000011110000000000000000000000000000000000000000000000000
1111100000000000000000000000000001000000000000000000011110010001001100100000000000000000000000000000000000
0111100100000001000000000000001111000000000000000000110000000000001000100000000000000000000000000000000000
0011111100000000000000000000000000000000000000000000111000011001001000000000000000000000000000000000000000
0000111110000000000000000000000000000000000000000000100000000001001000000000000000000000000000000111100000
0000111110100000000000000000000000000000000000000011100000000000000000000000000000000000000000110001000000
0001111110111000000000000000001100000000000000001010110000000000000000000000000000000000000000000000000000
0000011111110000000000000000011000000000000000000000000000000000000000000000000000000000000001000001101100
0000000011110000000000000000010000000000000000000000000000000000000000000000000000000001011001001001001000
0000001111111000000000000000000000000000000000000110100000000000000000000000000000000011001101100000000000
0000000111111100000000000000011100000000000000000000000000000000000000000000000000000011001000000000000000
0000000100111111000000000000000000000000000000001110000000000000000000000000000000000010001000000000000000
0000000000011111110000000000000100000000000000000000000000000000000000000000000010011110000000000000000000
0000000000001111111000000000000000000000000000011100000000000000000000000000000000010000000000000000000000
0001000000001111111100001000000100000000000011011000010000000000000000000000000000000000000000000000000000
0000000000000111111100101000000100000000000010000000000000000000000000000000000011110000000000000000000000
0000000000000111111100000000000000000000000000010000000000000000000000000000000000110000000000000000000000
0000000000000011111110000000000000000000000110010000000000000000000000000000000000000000000000000000000000
0000000000000001111111111000000000000000010110000000000000000000000000000000000000000000000000000000000000
0000000000000000001111000000000000000001010100000000000000000000000000000000000000000000000000000000000000
0000000000000000000111110000000000000111000000000000000000000000000000000000000000000000000000000000000000
0000000000000000100101111000000000000100000000000000000000000000000000000000000101000000000000000000000000
0000000000000000000101111100000001100111000000000000000000000000000000000010000000000000000000000000000000
0000000000000001100100111110000111100000000000000000000000000000000000000000000111000000000000000000000000
0000000000000000000000011111000111100000000000000000000000000000000000000110011110000000000000000000000000
0000000000000000000000001111000100000000000000000000000000000000000000000000011110000000000000000000000000
0000000000000000000000000111111110000000000000000000000000000000000000000100010000000000000000000000000111
0000000000000000000000000001111000000000000000000000000000000000000000000000000000000000000000000000000011
0000000011010000000000000001111000000000000000000000000000000000000000000000000000000001000000000000001110
0001000110010000000000000001111110000000000000000000000000000000000000000100000000000000000000000000000110
0001000100010101100000001111001111000000000000000000000000000000000000000000000010000000000000000000000000
0001000000000000000000001101001111100000000000000000000000000000000001100110010000000000000000000000000000
1111000000000000000000011100000111110110000010000000010000000000000000100010000000000000000000000000000000
1000000000000000000000011100000011111110000000000000000000000000000000110011000000000000000000000000000000
1000000000000000000000000000000001111110000000000000000010000000000000110010000000000000000000000000000000
1000000000000000000000000000000000111110000000000000000000000000000000000000000000000000000000000000000000
0000000000000000000001110000000001111111000000000000000000000000000000000010000000000000000000000000000000
1100000000000000000001010000000001111111100000000000000000000000000000000000000000000000000000000000000000
0000000000000000000011010000000000000111110000000000000000000000000000000000000000000000000000000000000000
1100000000000000000000000000000000000011111000000000000100000000000000000000000000000000000000000000000000
0000000000000000000110000000000000000001111110000000000000000000000000000000000000000000000000000000000000
0100000000000000000000000000000000000000111111100000000100000000000000000000000000000000000000000000000000
0000000000000000001110000000000000000000011111110000000000000000000000000000000000000000000000000000000000
0100000000000001101100000000000001000000011111111000010000000000000000000000000000000000000000000000000000
0100000000000001000000000000000000000000001111111001011100000000000000000000000000000000000000000000000000
0000000000000000000000000000000000000000001111111000000000000000000000000000000000000000000000000000000000
0000000000000011011000000000000000000000000111111000000000000000000000000000000000000000000000000000000000
0000000100001011000000000000000000000000000011111111110000000000000000000000000000000000000000000000000000
0000000000101010000000000000000000000000000000001111000000000000000000000000000000000000000000100000000000
0000001100101000000000000000000000000000000000001111100000000000000000000000000000000000000000100000000000
0000001000000000000000000000000000000000000001001111110000000000000000000000000000000000000000000000000000
0001111100100000000000000000000000000000000000001011111000000000000000000000000000000000000000000000000000
0111100100000001000000000000000001000000000011001001111000000000000000000000000000000000000000000000000000
0110100000000000000000000000000000000000000001000000111110111001000000000000000000000000000000000000000000
0110000000000000000000000000000000000000101001000000001111110000000000000000000000000000000000000000000000
1110000000000000000000000000000000010000000000000000001111110000000100000000000000000000000000000000000000
0000000000000000000000000000000000000000000000000000000111110000000000000000000000000000000000000000000000
0000000000000000000000000000000000000000000000000000001111111000000000000000000000000000000000000000000000
0010100000000000000000000000000000000000000000000000001111111001101100000000000000000000000000000000000000
0000100000000000000000000000000000000000000000000000001000111111100000000000000000000000000000000000000000
0000000000000000000000000000000000000000000000000000000000001111100000000000000000000000000000000000000000
0000000000000000000000000000000000000000000000000000000000001111100000000000000000000000000000000000000000
0010110000000000000000000000000000000000000000000000001000011111111000000000000000000000000000000000000000
0000000000000000000000000000000000000000000000000000000000011111111110000000000000000000000000000000000000
0000000000000000000000000000000000000000000000000000000000000001111111000000000000000000000000000000100000
0011110000000000000000000000000000000000000000000000000000010001111111100000000000000000000000000000000000
0010000000000000000000000000000000000000000000000000000010010000111111110000000000000000000000000000000000
0000000000000000000000000000000000000000000000000000000000000000111111111000000000000000000000000000000000
0000000000000000000000000000000010000000000000000000000000000000011111111100000000000000000000000000000000
1011000000000000000000000000000011110000000000000000000000000000001111111110000000000000000000000000000000
0000000000000000000000000000000000110000000000000000000000000000000111111111000000000000000000000000000000
0000000000000000000000000000000000000000000000000000000000000000000011111111100000000000000000000000000000
0000000000000000000000000101001010000000000000000000000000000000000001111111110000000000000000000000000001
0000000000000000000000010100000011110100000000000000000000000000000000111111110000000000000000000000000000
0000000000000000000000000000000000100000000000000000000000000000000000011111110000000000000000000000000000
0000000000000000000000000000000000000000000000000000000000000000000000001111110000000000000000000000000001
0000000000000000000000000111000010000000000000000000000000000000000000000111111100000000000000000000000000
0000000000000000000000000110000000000000000000000000000000000000000000000000011110000000000000000000000000
0000000000000000000000101110000000000000000000000000000000000000000000000000011111000000000000000000000000
0000000000000100100000001110000100000000000000000000000000000000000000000000001111101000000000000000000000
0000000000000000100000101000000000000000000000000000000000000000000000000000000111100000000000000000000000
0000000000000000110000000000000000000000000000000000000000000000000000000000000011111000000000000000000000
0000000000000110110000000000000000000000000000000000000000000000000000000000000000111000000000000000000000
0000000000000100000000000000000000000000000000000000000000000000000000000000000010111100000000000000000000
0000000000000100000000000000000000000000000000000000000000000000000000000000000000001111000000000000000000
0000000000111100000000000000000000000000000000000000000000000000000000000000000000000111101000000000000000
0000000001110000000000000000010000000000000000000000000000000000000000000000000000000111111001000000000000
0000000000000000000000000000000000000000000000000000000000000000000000000000000000000011111000000000000000
0000000001000000000000000000000000000000000000000000000000000000000000000000000000000001111111000000000000
0000000001111000000000000000000000000000000000000000000000000000000000000000000000000011111111100000000000
0000000000100000000000000000000000000000000000000000000000000000000000000000000000000000011111100000000000
0000000000000000000000000000000000000000000000000000000000000000000000000000000000000000011111101000000000
0000000011100000000000000000000000000000000000000000000000000000000000000000000000000001011111111001000000
0000001000100000000000000000000000000000000000000110000000000000000000000000000000000000001111111000000000
0000001000000000000000000000000000000000000000000000000000000000000000000000000000000000000001111100000000
0000000001000000000000000000000000000000000000000000000000000000000000000000000000000000000011111111000000
0000010000000000000000000000000000000000000000000000000000000000000000000000000000000000000000011111000000
0000010000000000000000000000000000000000000000000000000000000000000000000000000000000000000000001111110000
0000011011000000000000000000000000000000000000000000000000000000000000000000000000000000000001001111111100
0000010010000000000000000000000000000000000000000000000000000000010000000000000000000000000000000011111100
0000000000000000000000000000000000000000000000000000000000000000000000000000000000000000000000000011111100
0000000011000000000000000000010000000000000000000000000000000000000000000000000000000000000000000001111110
0000000010000000000000000001011000000000000000000000000000000000000000000000000000000000000000000001111111
0000000000000000000000000001111000000000000000000000000000000000000000000000000000000000000000000000001111
0000000000000000000000000001100000000000000000000000000000000000000000000100100000000000000000000000000111