152 sites
11100000000000000000000000000000000000000000000000000000000000000000000000000000000000000000000000000000000000000000000000000000000000000000000000000000
11110000000000000000000000000010100000000000000000000000000000000000000000000000000000000000000000000000000000000000000000000000000000000000000000000000
11110000000000000000000000000000000000000000000000000000000000000000000000000000000000000000000000000000000000000000000000000000000000000000000000000000
01111101000000000000000000000000000000000000000000000000000000000000000000000000000000000000000000000000000000000000000000000000000000000000000000000000
00011100000000000000000000000000010000000000000000000000000000000000000000000000000000000000000000000000000000000000000000000000000000000000000000000000
00011111000000000000000000000000010000000000000010000000000000000000000000000000000000000000000000000000000000000000000000000000000000000000000000000111
00000111100000000000000000000000111100000000111000000000000000000000000000000000000000000000000000000000000000000000000000000000000000000000000000001010
00010111110000000000000000000010110100000000000000000000000000000000000000000000000000000000000000000000000000000000000000000000000000000000000000011110
00000011111000000000000010000011100101000010000000000000000000000000000000000000000000000000000000000000000000000000000000000000000000000000000000011100
00000001111100000000000000011111000000000000000000000000000000000000000000000000000000000000000000000000000000000000000000000000000000000000000001110000
00000000111100000000001110000101000001000010000000000000000000000000000000000000000000000000000000000000000000000000000000000000000000000000000001110000
00000000011111000000001100111100000000000000000000000000000000000000000000000000000000000000000000000000000000000000000000000000000000000000000011100000
00000000000111101000111100000000000000000000000000000000100000000000000000000000000000000000000000000000000000000000000000000000000000001010000111000000
00000000000111111000011100000000000000000000000000000000000000000000000000000000000000000000000000000000000000000000000000000000000000000000000000000000
00000000000011111000000000000000000000000000000000000000000000000000000000000000000000000000000000000000000000000000000000000000000000000010000000000000
00000000000001111100010000000000000000000000000000000000000000000000000000000000000000000000000000000000000000000000000000000000000000000000000000000000
00000000000011111111110000000000000000000000000000000000000000000000000000000000000000000000000000000000000000000000000000000000000001000000000000000000
00000000000000011111000000000000000000000000000000000000000000000000000000000000000000000000000000000000000000000000000000000000000000000000000000000000
00000000000000001111000000000000000000000000000000000000000000000000000000000000000000000000000000000000000000000000000000000000000001100000000000000000
00000000000000001111110000000000000000000000000000000000000000000000000000000000000000000000000000000000000000000000000000000000000001000000000000000000
00000000000010001001111000000000000000001000000000000000100000000000000000000000000000000000000000000000000000000000000000000000111001001000000010000000
00000000000011011001111100000000000000001000000000000000000000000000000000000000000000000000000000000000000000000000000000000000000000000000000000000000
00000000001111000000111110000000000001001100000000000000000000000000000000000000000000000000000000000000000000000000000000000000100000000000000000100000
00000000001111000000011111100100000000000000000000000000000000000000000000000000000000000000000000000000000000000000000000000000000000000000000000000000
00000000101000000000001111000111000001000000000000000000000000000000000000000000000000000000000000000000000000000000000000000000000000000000000000000000
00000000000000000000000111100100000000000000000000000000000000000000000000000000000000000000000000000000000000000000000000000000000000000000000000000000
00000000000100000000000101110100000000000000000000000000000000000000000000000000000000000000000000000000000000000000000000000000000000000000000000000000
00000000010100000000000000111100000000000000000000000000000000000000000000000000000000000000000000000000000000000000000000000000000000000000011001000000
00000000010100000000000000011110000000000000000000000000000000000000000000000000000000000000000000000000000000000000000000000000000000000000000000000000
00000000011100000000000111111111000000000000000000000000000000000000000000000000000000000000000000000000000000000000000000000000000000000000000001000000
01000001110000000000000010001111100000000000000000000000000000000000000000000000000000000000000000000000000000000000000000000000000000000000000000010000
00000000111000000000000010000111100111000000000000000000000000000000000000000000000000000000000000000000000000000000000000000000000000000000000000000000
01000011100000000000000000000011111100000000000000000000000000000000000000000000000000000000000000000000000000000000000000000000000000000000000000000000
00001111000000000000000000000000111100000000010000000000000000000000000000000000000000000000000000000000000000000000000000000000000000000000000000000000
00000010000000000000000000000000111110000000011000000000000000000000000000000000000000000000000000000000000000000000000000000000000000000000000000000000
00000011100000000000000000000001111111000011110000000000000000000000000000000000000000000000000000000000000000000000000000000000000000000000000000001000
00000000000000000000000000000001001111100011010000000000000000000000000000000000000000000000000000000000000000000000000000000000000000000000000000000000
00000000101000000000001010000001000111101111000000000000000000000000000000000000000000000000000000000000000000000000000000000000000000000000000000000000
00000000000000000000000000000000000011111101000000000000000000000000000000000000000000000000000000000000000000000000000000000100000000000000000000000000
00000000000000000000000000000000000000111100000000000000000000000000000000000000000000000000000000000000000000000000000000000100000000000000000000000000
00000000000000000000111000000000000001111100000000000000000000000000000000000000000000000000000000000000000000000000000000000001000000000000000000000000
00000000000000000000001000000000000001111111000000000000000000000000000000000000000000000000000000000000000000000000000000000111000000000000000000000000
00000000101000000000000000000000000111000111100000000000000000000000000000000000000000000000000000000000000000000000000000000110000000000000000000111000
00000000000000000000000000000000000111100111110000000000000000000000000000000000000000000000000000000000000000000000000000011110000000000000000000000000
00000010000000000000000000000000000100000011111000100000000000000000000000000000000000000000000000000000000000000000000011111110000000000000000000001000
00000010000000000000000000000000011110000001111000000000000000000000000000000000000000000000000000000000000000000000000000100000000000000000000000000000
00000010000000000000000000000000001000000000111110000000000000000000000000000000000000000000000000000000000000000000000000100000000000000000000000000010
00000000000000000000000000000000000000000000001110000000000000000000000000000000000000000000000000000000000000000000000111100000000000000000000000000000
00000100000000000000000000000000000000000000001111100000000000000000000000000000000000000000000000000000000000000000000110000000000000000000000000000011
00000000000000000000000000000000000000000000000011110000000000000000000000000000000000000000000000000000000000000000011110000000000000000000000000000011
00000000000000000000000000000000000000000000100011111000000000000000000000000000000000000000000000000000000000000000011110000000000000000000000000001111
00000000000000000000000000000000000000000000000001111100000000000000000000000000000000000000000000000000000000000001110000000000000000000000000000001101
00000000000000000000000000000000000000000000000000111110000000000000000000100000000000011000000000000000000000000001111000000010000000000000000000011000
00000000000000000000000000000000000000000000000000011111000000000000000000000000000000000000000000000000000000000111100000000000000000000000000000111000
00000000000000000000000000000000000000000000000000001111100000000000000010100000000000001000000000000000000000000111000000000000100000000000000001110000
00000000000000000000000000000000000000000000000000000111110000000000000000000000000000000000000000000000000000011110000000000000000000000000000111000000
00000000000010000000100000000000000000000000000000000011111000000000000010000000000000000000000000000000000000011000000000000000001000001000000110000000
00000000000000000000000000000000000000000000000000000001111100000000000000000000000000000000000000000000000001111000000000000000000000001100100110000000
00000000000000000000000000000000000000000000000000000000111110000000001000000000000000000000101000000000000001111000000000000000000010011100000000000000
00000000000000000000000000000000000000000000000000000000011111000000000000000000000000000000000000000000000111100000000000000000000000011101000000000000
00000000000000000000000000000000000000000000000000000000001111101000100000000000000000000000001100000000000110000000000000000000000000010000000000000000
00000000000000000000000000000000000000000000000000000000000111100000000000000000000000000000000000000000111110000000000000000000000000000000000000000000
00000000000000000000000000000000000000000000000000000000000011111000000000000000000000000000000100101001111010000000000000000000000000000000000000000000
00000000000000000000000000000000000000000000000000000000000000111010100000000000000000000000001101111000000000000000000000000000000000000000000000000000
00000000000000000000000000000000000000000000000000000000000010111100100000000000000000000000000100000000000000000000000000000000000000000000000000000000
00000000000000000000000000000000000000000000000000000000000000001111000000000000000000000000000000000000000000000000000000000000000000000000000000000000
00000000000000000000000000000000000000000000000000000000000000010111000000000000000000000000000101110000000000000000000000000000000000000000000000000000
00000000000000000000000000000000000000000000000000000000000000000111110000000000000000000000010000000000000000000000000000000000000000000000000000000000
00000000000000000000000000000000000000000000000000000000000010011001111000000000000000000000011100000000000000000000000000000000000010010000000000000000
00000000000000000000000000000000000000000000000000000000000000000001111100000000000000000001110000000000000000000000000000000000000110000000000000000000
00000000000000000000000000000000000000000000000000000000001000000000111110000000000000000001111000000000000000101000000000000000001110010000000000000000
00000000000000000000000000000000000000000000000000000000000000000000011111000000000000000111100000000000000000000000000000000000001110000000000000000000
00000000000000000000000000000000000000000000000000000010100000000000001111100000000000000111000000000000000000001010000000000000111000000000000000000000
00000000000000000000000000000000000000000000000000000000000000000000000111110000000000101100000000000000000000000000000000000000111000000000000000000000
00000000000000000000000000000000000000000000000000001010000000000000000011111000000000111100000000000000000000000010000000000011110000000000000000100000
00000000000000000000000000000000000000000000000000000000000000000000000001111100000011110000000000000000000000000000000000000011010000000000000000000000
00000000000000000000000000000000000000000000000000000000000000000000000000111110000011010000000000000000000000000000001010001110000000000000000000000000
00000000000000000000000000000000000000000000000000000000000000000000000000011110011111000000000000000000000000000000000000001111000000000000000000000000
00000000000000000000000000000000000000000000000000000000000000000000000000001111111101000000000000000000000000000000000001001000000000000000000000000000
00000000000000000000000000000000000000000000000000000000000000000000000000000011101000000000000000000000000000000000000001111000000000000000000000000000
00000000000000000000000000000000000000000000000000000000000000000000000000000011111000000000000000000000000000000000000001000000000000000000000000000000
00000000000000000000000000000000000000000000000000000000000000000000000000000110111101000000000000000000000000000000000000000000000000000000000000000000
00000000000000000000000000000000000000000000000000000000000000000000000000000111111100000000000000000000000000000000000000000000000000000000000000000000
00000000000000000000000000000000000000000000000000000000000000000000000000000110011111000000000000000000000000000000000000000000000000000000000000000000
00000000000000000000000000000000000000000000000000000000000000000000000000011100000111100000000000000000000000000000000000000001000000000000000000000000
00000000000000000000000000000000000000000000000000000000000000000000000000011110010111110000000000000000000000000000000000000000000000000000000000000000
00000000000000000000000000000000000000000000000000000000000000000000000001110000000011111100000000000000000000000000000000000000000000000000000000000000
00000000000000000000000000000000000000000000000000001000000000000000000000111000000001111000000000000000000000000000101000000010000000000000000000000000
00000000000000000000000000000000000000000000000000001010000000000000000001100000000000111110000000000000000000000011100000000000000000000000000000000000
00000000000000000000000000000000000000000000000000000000000000000000000111100000000000101111000000000000000000000010000000000000000000000000000000000000
00000000000000000000000000000000000000000000000000000000000000000000000110000000000000001111100000000000000000001010000000000000000000000000000000000000
00000000000000000000000000000000000000000000000000000000000000000000011110000000000000000111110000000000000000000000000000000000000000000000000000000000
00000000000000000000000000000000000000000000000000000000001000000000011100000000000000000011111000000000000000101000000000000000000000000000000000000000
00000000000000000000000000000000000000000000000000000000000000000001111000000000000000000001111110000000000000000000000000000000000000000000000000000000
00000000000000000000000000000000000000000000000000000000001010010000101000000000000000000000111110000000000010100000000000000000000000000000000000000000
00000000000000000000000000000000000000000000000000000000000010111010100000000000000000000000011111111000000010000000000000000000000000000000000000000000
00000000000000000000000000000000000000000000000000000000000000000000000000000000000000000000011111100000000000000000000000000000000000000000000000000000
00000000000000000000000000000000000000000000000000000000000000010010000000000000000000000000000111110000000000000000000000000000000000000000000000000000
00000000000000000000000000000000000000000000000000000000000000110010000000000000000000000000000111111000000000000000000000000000000000000000000000000000
00000000000000000000000000000000000000000000000000000000000000010010000000000000000000000000000101111100000000000000000000000000000000000000000000000000
00000000000000000000000000000000000000000000000000000000000000110000000000000000000000000000000100111111101000000000000000000000000000000000000000000000
00000000000000000000000000000000000000000000000000000000000000000000000000000000000000000000000000011111100000000000000000000000000000000000000000000000
00000000000000000000000000000000000000000000000000000000000000000000000000000000000000000000000000001111100000000000000000000000000000000000000000000000
00000000000000000000000000000000000000000000000000000000000000100000000000000000000000000000000000001111111000000000000000000000000000000000000000000000
00000000000000000000000000000000000000000000000000000000000001100000000000000000000000000000000000001111111000000000000000000000000000000000000000000000
00000000000000000000000000000000000000000000000000000000000001100000000000000000000000000000000000000001111100000000000000000000000000000000000000000000
00000000000000000000000000000000000000000000000000000000000001100000000000000000000000000000000000001001111110000000000000000000000000000000000000000000
00000000000000000000000000000000000000000000000000000000000111000000000000000000000000000000000000000000011111000000000000000000000000000000000000000000
00000000000000000000000000000000000000000000000000000000000111100000000000000000000000000000001100000000001111100000000000000000000000000000000000000000
00000000000000000000000000000000000000000000000000000000011100000000000000000000000000000000000000000000000111110000000000000000000000000100000000000000
00000000000000000000000000000000000000000000000000000000011100000000001000000000000000000000101000000000000011111000000000000000000000000000000000000000
00000000000000000000000000000000000000000000000000000001111000000000000000000000000000000000000000000000000001111100000000000000000000000000000000000000
00000000000000000000000000000000000000000000000000000001111000000000001010000000000000000010100000000000000000111110000000000000000000000000000000000000
00000000000000000000000000000000000000000000000000000111000000000000000000000000000000000000000000000000000000011111000000000000000000000000000000000000
00000000000000000000000000000000000000000000000000000111000000000000000010100000000000001110000000000000000000001111100000000000000000000000000000000000
00000000000000000000000000000000000000000000000000011110000000000000000000000000000000001000000000000000000000000111100000000000000000000000000000000000
00000000000000000000000000000000000000000000000000011100000000000000000000000000000000011000000000000000000000000011111000000000000000000000000000000000
00000000000000000000000000000000000000000000000001111000000000000000000000000000000000000000000000000000000000000000111000000000000000000000000000000001
00000000000000000000000000000000000000000000000001101000000000000000000000001000000000010000000000000000000000000000111110000000000000000000000000000000
00000000000000000000000000000000000000000000000111100000000000000000000000000000000000000000000000000000000000000000001111000000000000000000000000000000
00000000000000000000000000000000000000000000100111100000000000000000000000001000000000000000000000000000000000000000001111001010000000000000000000001000
00000000000000000000000000000000000000000000100100000000000000000000000000000011100000000000000000000000000000000000000111111000000000000000000000000000
00000000000000000000000000000000000000000000111100000000000000000000000000000001000000000000000000000000000000000000000001111000000000000000000000000000
00000000000000000000000000000000000000000001100000000000000000000000000000000001000000000000000000000000000000000000000001111100000000000000000000000000
00000000000000000000000000000000000000000001100000000000000000000000000000001111000000000000000000000000000000000000000011111110000000000000000000000000
00000000000000000000000000000000000000110111100000000000000000000000000000001100000000000000000000000000000000000000000000011111000000000000000000000000
00000000000000000000000000000000000000000111100000001000000000000000000000111100000000010000000000000000000000000000000010001111100000000000000000001000
00000000000000000000000000000000000000001100000000000000000000000000000000110100000010000000000000000000000000000000000000000111110000000000000000000000
00000000000000000000101000000000000000000000000000000010000000000000000011100000000000000000000000000000000000000000000000000011111000000000000000100000
00000000000000000000100000000000000000000000000000000000000000000000000011110000000000000000000000000000000000000000000000000001111100000000000000000000
00000000000000000000100000000000000000000000000000000000100000000000001111000000000000000000000000000000000000000000000000000000111111001000000000000000
00000000000000000000000000000000000000000000000000000000000000000000011100000000000000000000000000000000000000000000000000000000011110000000000000000000
00000000000000000000000000000000000000000000000000000000001000000000111100000000000000000000000000000000000000000000000000000000001111111000000000000000
00000000000000001011100000000000000000000000000000000000000000000000000000000000000000000000000000000000000000000000000000000000001011111000000000000000
00000000000000000010000000000000000000000000000000000000000000000000000000000000000000000000000000000000000000000000000000000000000011111000000000000000
00000000000000000000000000000000000000000000000000000000001110000000101000000000000000000000000000000000000000000000000000000000000011111100000000000000
00000000000010000000100000000000000000000000000000000000111100000000000000000000000000000000000000000000000000000000000000000000001011111110000010000000
00000000000000000000000000000000000000000000000000000000011100000000000000000000000000000000000000000000000001000000000000000000000000011111100110000000
00000000000010100000000000000000000000000000000000000000000000000000000000000000000000000000000000000000000000000000000000000000000000001111100110000000
00000000000000000000000000000000000000000000000000000000000100000000000000000000000000000000000000000000000000000000000000000000000000000111100100000000
00000000000000000000000000000000000000000000000000000000010000000000000000000000000000000000000000000000000000000000000000000000000000000111111100000000
00000000000000000000000000010000000000000000000000000000000000000000000000000000000000000000000000000000000000000000000000000000000000000000111100000000
00000000000000000000000000010000000000000000000000000000000000000000000000000000000000000000000000000000000000000000000000000000000000000000111101000000
00000000000010000000000000000000000000000000000000000001110000000000000000000000000000000000000000000000000000000000000000000000000000000111111111000000
00000000000110000000100000000000000000000000000000000001110000000000000000000000000000000000000000000000000000000000000000000000000000001110000111000000
00000000011110000000000000010100000000000000000000000011000000000000000000000000000000000000000000000000000000000000000000000000000000000000001111110000
00000000011100000000001000000000000000000010000000000110000000000000000000100000000000000000000000000000000000000000000000000000100000000000000001110000
00000001111000000000000000000010000000000010000000001110000000000000000000000000000000000000000000000000000000000000000000000000000000000000000001111100
00000011100000000000000000000000000100000010100000111100000000000000000000000000000000000000000000000000000000000000000010000010000000000000000000011110
00000101100000000000000000000000000000000000000000110000000000000000000000000000000000000000000000000000000000000000000000000000000000000000000000011111
00000111000000000000000000000000000000000000001011100000000000000000000000000000000000000000000000000000000000000000000000000000000000000000000000001111
00000100000000000000000000000000000000000000000011110000000000000000000000000000000000000000000000000000000000000000010000000000000000000000000000000111