50 sites
11111000000000000000000000000000000000000000000000
11111100000000000000000000000000000000000000000000
11111110000000000000000000000000000000000000000000
11111111000000000000000000000000000000000000000000
11111111100000000000000000000000000000000000000000
01111111110000000000000000000000000000000000000000
00111111111000000000000000000000000000000000000000
00011111111100000000000000000000000000000000000000
00001111111110000000000000000000000000000000000000
00000111111111000000000000000000000000000000000000
00000011111111100000000000000000000000000000000000
00000001111111110000000000000000000000000000000000
00000000111111111000000000000000000000000000000000
00000000011111111100000000000000000000000000000000
00000000001111111110000000000000000000000000000000
00000000000111111111000000000000000000000000000000
00000000000011111111100000000000000000000000000000
00000000000001111111110000000000000000000000000000
00000000000000111111111000000000000000000000000000
00000000000000011111111100000000000000000000000000
00000000000000001111111110000000000000000000000000
00000000000000000111111111000000000000000000000000
00000000000000000011111111100000000000000000000000
00000000000000000001111111110000000000000000000000
00000000000000000000111111111000000000000000000000
00000000000000000000011111111100000000000000000000
00000000000000000000001111111110000000000000000000
00000000000000000000000111111111000000000000000000
00000000000000000000000011111111100000000000000000
00000000000000000000000001111111110000000000000000
00000000000000000000000000111111111000000000000000
00000000000000000000000000011111111100000000000000
00000000000000000000000000001111111110010000000000
00000000000000000000000000000111111111011000000000
00000000000000000000000000000011111111000000000000
00000000000000000000000000000001111110000000000000
00000000000000000000000000000000111111110000000000
00000000000000000000000000000000011011111000000000
00000000000000000000000000000000000011111110000000
00000000000000000000000000000000110011111111000000
00000000000000000000000000000000010001111111100000
00000000000000000000000000000000000000111111110000
00000000000000000000000000000000000000111111111000
00000000000000000000000000000000000000011111111100
00000000000000000000000000000000000000001111111111
00000000000000000000000000000000000000000111111110
00000000000000000000000000000000000000000011111110
00000000000000000000000000000000000000000001111111
00000000000000000000000000000000000000000000111111
00000000000000000000000000000000000000000000100111